Year,Host_City,Host_Country,Country,Country_Code,Gold,Silver,Bronze,M_Total,Men,Women,P_Total,Population,P_TotalPer10MPop,Continent
1960,Rome,Italy,Argentina,ARG,2,3,1,6,5,4,9,20481781,4.39,South America
1960,Rome,Italy,Australia,AUS,3,6,1,10,10,1,11,10276477,10.7,Oceania
1960,Rome,Italy,Austria,AUT,11,8,11,30,12,7,19,7047539,26.96,Europe
1960,Rome,Italy,Belgium,BEL,1,1,1,3,10,2,12,9153489,13.11,Europe
1960,Rome,Italy,Finland,FIN,1,0,0,1,1,0,1,4429634,2.26,Europe
1960,Rome,Italy,France,FRA,3,3,1,7,10,1,11,46621688,2.36,Europe
1960,Rome,Italy,Germany,GER,15,6,9,30,7,2,9,72814900,1.24,Europe
1960,Rome,Italy,Great Britain,GBR,20,15,20,55,29,13,42,52400000,8.02,Europe
1960,Rome,Italy,Ireland,IRL,2,0,0,2,0,1,1,2828600,3.54,Europe
1960,Rome,Italy,Israel,ISR,0,2,2,4,6,1,7,2114020,33.11,Asia
1960,Rome,Italy,Italy,ITA,29,28,23,80,23,4,27,50199700,5.38,Europe
1960,Rome,Italy,Malta,MLT,0,2,2,4,5,1,6,326550,183.74,Europe
1960,Rome,Italy,Netherlands,NED,3,6,0,9,11,2,13,11486631,11.32,Europe
1960,Rome,Italy,Norway,NOR,9,3,4,16,7,4,11,3581239,30.72,Europe
1972,Heidelberg,Germany,Bahamas,BAH,0,0,0,0,1,0,1,177863,0.00,North America
1960,Rome,Italy,Switzerland,SUI,1,3,0,4,5,1,6,5327827,11.26,Europe
1960,Rome,Italy,United States of America,USA,11,7,7,25,23,0,23,180671000,1.27,North America
1964,Tokyo,Japan,Argentina,ARG,6,15,16,37,19,6,25,21824427,11.46,South America
1964,Tokyo,Japan,Australia,AUS,12,11,7,30,13,4,17,11167000,15.22,Oceania
1964,Tokyo,Japan,Austria,AUT,4,1,7,12,3,4,7,7223801,9.69,Europe
1964,Tokyo,Japan,Belgium,BEL,1,0,2,3,1,1,2,9378113,2.13,Europe
1964,Tokyo,Japan,Fiji,FIJ,0,0,0,0,1,0,1,450538,22.2,Oceania
1964,Tokyo,Japan,France,FRA,4,2,5,11,13,0,13,49230585,2.64,Europe
1964,Tokyo,Japan,Germany,GER,5,2,5,12,8,1,9,75318337,1.19,Europe
1964,Tokyo,Japan,Great Britain,GBR,18,23,20,61,30,14,44,54000000,8.15,Europe
1964,Tokyo,Japan,Ireland,IRL,0,0,0,0,2,0,2,2866550,6.98,Europe
1964,Tokyo,Japan,Israel,ISR,7,3,11,21,16,3,19,2475000,76.77,Asia
1964,Tokyo,Japan,Italy,ITA,14,15,16,45,14,5,19,51675350,3.68,Europe
1964,Tokyo,Japan,Japan,JPN,1,5,4,10,14,2,16,96903000,1.65,Asia
1964,Tokyo,Japan,Malta,MLT,0,0,2,2,2,0,2,321250,62.26,Europe
1964,Tokyo,Japan,Netherlands,NED,4,6,4,14,4,3,7,12127120,5.77,Europe
1976,Toronto,Canada,Bahamas,BAH,0,0,0,0,6,0,6,192903,0.00,North America
1964,Tokyo,Japan,South Africa,RSA,8,8,3,19,5,4,9,18896303,4.76,Africa
1964,Tokyo,Japan,Sweden,SWE,0,0,1,1,1,0,1,7661354,1.31,Europe
1964,Tokyo,Japan,Switzerland,SUI,0,1,0,1,0,1,1,5789228,1.73,Europe
1964,Tokyo,Japan,United States of America,USA,50,41,32,123,45,20,65,191889000,3.39,North America
1980,Arnhem,Netherlands,Bahamas,BAH,0,1,2,3,2,4,6,210589,0.00,North America
1968,Tel Aviv,Israel,Argentina,ARG,10,10,10,30,14,7,21,23168268,9.06,South America
1968,Tel Aviv,Israel,Australia,AUS,15,16,7,38,23,12,35,12009000,29.14,Oceania
1968,Tel Aviv,Israel,Austria,AUT,2,7,10,19,19,12,31,7415403,41.8,Europe
1968,Tel Aviv,Israel,Belgium,BEL,0,3,3,6,21,5,26,9618756,27.03,Europe
1968,Tel Aviv,Israel,Canada,CAN,6,6,7,19,18,7,25,20744000,12.05,North America
1968,Tel Aviv,Israel,Denmark,DEN,0,0,0,0,7,1,8,4864883,16.44,Europe
1968,Tel Aviv,Israel,Ethiopia,ETH,0,0,0,0,2,0,2,26944386,0.74,Africa
1968,Tel Aviv,Israel,Finland,FIN,0,0,0,0,2,0,2,4626469,4.32,Europe
1968,Tel Aviv,Israel,France,FRA,13,10,9,32,40,14,54,51175507,10.55,Europe
1968,Tel Aviv,Israel,Great Britain,GBR,29,20,20,69,50,24,74,55211700,13.4,Europe
1968,Tel Aviv,Israel,India,IND,0,0,0,0,8,2,10,531513834,0.19,Asia
1968,Tel Aviv,Israel,Ireland,IRL,0,4,5,9,5,2,7,2915550,24.01,Europe
1968,Tel Aviv,Israel,Israel,ISR,18,21,23,62,38,16,54,2803000,192.65,Asia
1968,Tel Aviv,Israel,Italy,ITA,12,10,17,39,33,5,38,53235750,7.14,Europe
1968,Tel Aviv,Israel,Jamaica,JAM,3,1,1,5,7,4,11,1825873,60.25,North America
1968,Tel Aviv,Israel,Japan,JPN,2,2,8,12,40,7,47,101011000,4.65,Asia
1968,Tel Aviv,Israel,Republic of Korea,KOR,0,0,0,0,5,0,5,30838302,1.62,Asia
1968,Tel Aviv,Israel,Malta,MLT,0,0,0,0,4,2,6,307900,194.87,Europe
1968,Tel Aviv,Israel,Netherlands,NED,12,4,4,20,24,11,35,12729721,27.49,Europe
1968,Tel Aviv,Israel,New Zealand,NZL,1,2,1,4,17,1,18,2748100,65.5,Oceania
1968,Tel Aviv,Israel,Norway,NOR,5,3,1,9,18,9,27,3816486,70.75,Europe
1984,"Stoke Mandeville, New York","Great Britain, United States of America",Bahamas,BAH,0,1,1,2,0,2,2,229913,0.00,North America
1968,Tel Aviv,Israel,South Africa,RSA,9,10,7,26,5,3,8,20942147,3.82,Africa
1968,Tel Aviv,Israel,Spain,ESP,0,3,1,4,9,2,11,33113134,3.32,Europe
1968,Tel Aviv,Israel,Sweden,SWE,1,6,4,11,27,5,32,7912273,40.44,Europe
1968,Tel Aviv,Israel,Switzerland,SUI,0,2,6,8,32,2,34,6067714,56.03,Europe
1968,Tel Aviv,Israel,United States of America,USA,33,27,39,99,53,29,82,200706000,4.09,North America
1988,Seoul,Republic of Korea,Bahamas,BAH,0,0,0,0,2,2,4,247451,0.00,North America
1972,Heidelberg,Germany,Argentina,ARG,2,4,3,9,12,9,21,24653172,8.52,South America
1972,Heidelberg,Germany,Australia,AUS,6,9,10,25,28,9,37,13177000,28.08,Oceania
1972,Heidelberg,Germany,Austria,AUT,6,6,6,18,22,10,32,7544201,42.42,Europe
1996,Atlanta,United States of America,Cote d'Ivoire,CIV,2,0,0,2,2,0,2,14665125,0.00,Africa
1972,Heidelberg,Germany,Belgium,BEL,1,1,2,4,18,5,23,9711115,23.68,Europe
1972,Heidelberg,Germany,Brazil,BRA,0,0,0,0,8,0,8,99859388,0.8,South America
1972,Heidelberg,Germany,Canada,CAN,5,6,8,19,27,13,40,22218463,18,North America
2000,Sydney,Australia,Cote d'Ivoire,CIV,1,0,1,2,2,0,2,16454660,0.00,Africa
1972,Heidelberg,Germany,Denmark,DEN,0,0,0,0,8,2,10,4991596,20.03,Europe
1972,Heidelberg,Germany,Egypt,EGY,0,0,0,0,1,0,1,36102670,0.28,Africa
1972,Heidelberg,Germany,Finland,FIN,0,2,1,3,20,4,24,4639657,51.73,Europe
1972,Heidelberg,Germany,France,FRA,10,8,15,33,42,19,61,52793151,11.55,Europe
1972,Heidelberg,Germany,Great Britain,GBR,16,15,21,52,48,25,73,56086065,13.02,Europe
1972,Heidelberg,Germany,Hong Kong,HKG,0,1,1,2,10,0,10,4123600,24.25,Asia
1972,Heidelberg,Germany,Hungary,HUN,0,0,1,1,4,1,5,10398489,4.81,Europe
1972,Heidelberg,Germany,India,IND,1,0,0,1,7,3,10,581087255,0.17,Asia
1972,Heidelberg,Germany,Ireland,IRL,2,4,2,8,8,9,17,3036850,55.98,Europe
1972,Heidelberg,Germany,Israel,ISR,9,10,9,28,19,11,30,3148000,95.3,Asia
1972,Heidelberg,Germany,Italy,ITA,8,4,5,17,20,5,25,54381345,4.6,Europe
1972,Heidelberg,Germany,Jamaica,JAM,8,3,4,15,13,7,20,1935089,103.35,North America
1972,Heidelberg,Germany,Japan,JPN,4,5,3,12,23,5,28,107188000,2.61,Asia
1972,Heidelberg,Germany,Kenya,KEN,1,0,0,1,4,0,4,12146070,3.29,Africa
1972,Heidelberg,Germany,Republic of Korea,KOR,4,2,1,7,7,1,8,33505406,2.39,Asia
1972,Heidelberg,Germany,Malaysia,MAS,0,0,0,0,4,0,4,11324277,3.53,Asia
1972,Heidelberg,Germany,Malta,MLT,0,0,0,0,5,3,8,302450,264.51,Europe
1972,Heidelberg,Germany,Mexico,MEX,0,0,0,0,7,0,7,54689944,1.28,North America
1972,Heidelberg,Germany,Netherlands,NED,14,13,11,38,26,12,38,13328593,28.51,Europe
1972,Heidelberg,Germany,New Zealand,NZL,3,3,3,9,7,3,10,2903900,34.44,Oceania
1972,Heidelberg,Germany,Norway,NOR,1,5,4,10,18,9,27,3933004,68.65,Europe
1972,Heidelberg,Germany,Peru,PER,0,0,0,0,1,0,1,14221954,0.7,South America
1972,Heidelberg,Germany,Poland,POL,14,12,7,33,12,10,22,33055650,6.66,Europe
2004,Athens,Greece,Cote d'Ivoire,CIV,0,0,0,0,2,0,2,17970493,0.00,Africa
1972,Heidelberg,Germany,Romania,ROU,0,0,0,0,1,0,1,20657957,0.48,Europe
1972,Heidelberg,Germany,South Africa,RSA,16,12,13,41,12,13,25,23281517,10.74,Africa
1972,Heidelberg,Germany,Spain,ESP,0,4,0,4,11,9,20,34604469,5.78,Europe
1972,Heidelberg,Germany,Sweden,SWE,5,6,6,17,30,8,38,8122300,46.78,Europe
1972,Heidelberg,Germany,Switzerland,SUI,3,2,4,9,32,4,36,6260956,57.5,Europe
1972,Heidelberg,Germany,Uganda,UGA,0,0,0,0,2,0,2,9929644,2.01,Africa
1972,Heidelberg,Germany,United States of America,USA,17,27,31,75,49,17,66,209896000,3.14,North America
2008,Beijing,China,Cote d'Ivoire,CIV,0,0,0,0,3,0,3,19605568,0.00,Africa
2012,London,Great Britain,Cote d'Ivoire,CIV,0,0,0,0,3,1,4,21547188,0.00,Africa
1976,Toronto,Canada,Argentina,ARG,3,4,7,14,8,12,20,26264681,7.61,South America
1976,Toronto,Canada,Australia,AUS,16,18,7,41,35,11,46,14033000,32.78,Oceania
1976,Toronto,Canada,Austria,AUT,18,16,17,51,32,10,42,7565525,55.51,Europe
2016,Rio de Janeiro,Brazil,Cote d'Ivoire,CIV,0,1,0,1,3,2,5,23822726,0.00,Africa
1976,Toronto,Canada,Belgium,BEL,7,7,8,22,41,4,45,9818227,45.83,Europe
1976,Toronto,Canada,Brazil,BRA,0,1,0,1,21,2,23,109790943,2.09,South America
2020,Tokyo,Japan,Cote d'Ivoire,CIV,0,0,0,0,2,1,3,26378275,0.00,Africa
1976,Toronto,Canada,Canada,CAN,25,26,26,77,66,23,89,23449808,37.95,North America
1976,Toronto,Canada,Colombia,COL,0,0,0,0,8,3,11,24608102,4.47,South America
1976,Toronto,Canada,Denmark,DEN,3,0,3,6,19,2,21,5072596,41.4,Europe
1976,Toronto,Canada,Ecuador,ECU,0,0,0,0,3,0,3,7187794,4.17,South America
1976,Toronto,Canada,Egypt,EGY,5,2,1,8,27,0,27,39422731,6.85,Africa
1976,Toronto,Canada,Ethiopia,ETH,0,0,0,0,1,0,1,33128151,0.3,Africa
1976,Toronto,Canada,Fiji,FIJ,0,0,0,0,9,0,9,587561,153.18,Oceania
1976,Toronto,Canada,Finland,FIN,12,20,18,50,46,4,50,4725664,105.81,Europe
1976,Toronto,Canada,France,FRA,23,21,14,58,42,10,52,54220033,9.59,Europe
1976,Toronto,Canada,Great Britain,GBR,29,28,37,94,64,23,87,56211968,15.48,Europe
1976,Toronto,Canada,Greece,GRE,0,0,0,0,3,0,3,9188150,3.27,Europe
1976,Toronto,Canada,Guatemala,GUA,0,0,1,1,11,0,11,6269983,17.54,North America
1976,Toronto,Canada,Hong Kong,HKG,0,1,2,3,11,0,11,4518000,24.35,Asia
1976,Toronto,Canada,Hungary,HUN,1,0,1,2,2,0,2,10598677,1.89,Europe
1976,Toronto,Canada,Indonesia,INA,2,1,3,6,12,0,12,133966940,0.9,Asia
1976,Toronto,Canada,Ireland,IRL,4,10,6,20,8,11,19,3238050,58.68,Europe
1976,Toronto,Canada,Israel,ISR,40,13,16,69,50,9,59,3533000,167,Asia
1976,Toronto,Canada,Italy,ITA,2,5,11,18,22,2,24,55718260,4.31,Europe
1976,Toronto,Canada,Japan,JPN,10,6,3,19,30,4,34,112775000,3.01,Asia
1976,Toronto,Canada,Republic of Korea,KOR,1,2,1,4,7,0,7,35848523,1.95,Asia
1976,Toronto,Canada,Luxembourg,LUX,0,0,0,0,2,1,3,360731,83.16,Europe
1976,Toronto,Canada,Mexico,MEX,16,14,9,39,24,8,32,61242189,5.23,North America
1976,Toronto,Canada,Netherlands,NED,45,25,14,84,41,17,58,13774037,42.11,Europe
1976,Toronto,Canada,New Zealand,NZL,7,1,5,13,11,1,12,3110500,38.58,Oceania
1976,Toronto,Canada,Norway,NOR,9,6,4,19,26,15,41,4026152,101.83,Europe
1976,Toronto,Canada,Peru,PER,1,0,2,3,1,1,2,15838568,1.26,South America
1976,Toronto,Canada,Poland,POL,24,17,12,53,23,14,37,34356300,10.77,Europe
1976,Toronto,Canada,South Africa,RSA,6,9,11,26,27,10,37,25836890,14.32,Africa
1976,Toronto,Canada,Spain,ESP,4,6,2,12,21,1,22,36137812,6.09,Europe
1976,Toronto,Canada,Sweden,SWE,21,28,25,74,56,13,69,8222286,83.92,Europe
1976,Toronto,Canada,Switzerland,SUI,9,12,10,31,40,9,49,6302504,77.75,Europe
1976,Toronto,Canada,Uganda,UGA,0,0,0,0,1,0,1,11042975,0.91,Africa
1976,Toronto,Canada,United States of America,USA,66,44,45,155,63,34,97,218035000,4.45,North America
1972,Heidelberg,Germany,Czechoslovakia,TCH,0,0,1,1,14,5,19,9867632,0.00,Europe
1980,Arnhem,Netherlands,Argentina,ARG,4,5,6,15,6,5,11,27896532,3.94,South America
1980,Arnhem,Netherlands,Australia,AUS,12,21,22,55,40,12,52,14692000,35.39,Oceania
1980,Arnhem,Netherlands,Austria,AUT,14,23,8,45,38,10,48,7549433,63.58,Europe
1980,Arnhem,Netherlands,Czechoslovakia,TCH,0,1,1,2,5,2,7,10304193,0.00,Europe
1980,Arnhem,Netherlands,Belgium,BEL,13,12,17,42,54,13,67,9859242,67.96,Europe
1980,Arnhem,Netherlands,Brazil,BRA,0,0,0,0,2,0,2,120694012,0.17,South America
1980,Arnhem,Netherlands,Canada,CAN,64,35,31,130,60,34,94,24515667,38.34,North America
1980,Arnhem,Netherlands,Colombia,COL,1,0,1,2,8,3,11,26900508,4.09,South America
1988,Seoul,Republic of Korea,Czechoslovakia,TCH,0,1,0,1,1,0,1,10355276,0.00,Europe
1980,Arnhem,Netherlands,Denmark,DEN,6,4,7,17,32,10,42,5123027,81.98,Europe
1980,Arnhem,Netherlands,Egypt,EGY,4,7,3,14,26,7,33,43309063,7.62,Africa
1980,Arnhem,Netherlands,Ethiopia,ETH,0,0,0,0,1,0,1,35141703,0.28,Africa
1980,Arnhem,Netherlands,Finland,FIN,8,19,13,40,50,10,60,4779535,125.54,Europe
1980,Arnhem,Netherlands,France,FRA,28,26,31,85,76,21,97,55161510,17.58,Europe
1980,Arnhem,Netherlands,Great Britain,GBR,47,32,21,100,65,31,96,56314216,17.05,Europe
1980,Arnhem,Netherlands,Greece,GRE,0,0,1,1,6,1,7,9642505,7.26,Europe
1980,Arnhem,Netherlands,Hong Kong,HKG,0,1,2,3,11,0,11,5063100,21.73,Asia
1980,Arnhem,Netherlands,Iceland,ISL,1,0,1,2,8,4,12,228138,526,Europe
1980,Arnhem,Netherlands,Indonesia,INA,2,0,4,6,15,0,15,147447834,1.02,Asia
1980,Arnhem,Netherlands,Ireland,IRL,4,2,11,17,14,9,23,3412800,67.39,Europe
1980,Arnhem,Netherlands,Israel,ISR,13,18,15,46,40,7,47,3878000,121.2,Asia
1980,Arnhem,Netherlands,Italy,ITA,6,5,9,20,29,9,38,56433883,6.73,Europe
1980,Arnhem,Netherlands,Jamaica,JAM,7,7,5,19,6,7,13,2162839,60.11,North America
1980,Arnhem,Netherlands,Japan,JPN,9,10,7,26,24,6,30,116807000,2.57,Asia
1980,Arnhem,Netherlands,Kenya,KEN,1,2,0,3,13,4,17,16417203,10.35,Africa
1980,Arnhem,Netherlands,Republic of Korea,KOR,2,2,1,5,12,0,12,38123775,3.15,Asia
1980,Arnhem,Netherlands,Kuwait,KUW,2,2,1,5,7,2,9,1368680,65.76,Asia
1980,Arnhem,Netherlands,Luxembourg,LUX,0,0,1,1,8,1,9,364150,247.15,Europe
1980,Arnhem,Netherlands,Malta,MLT,0,0,1,1,5,3,8,316645,252.65,Europe
1980,Arnhem,Netherlands,Mexico,MEX,20,16,6,42,19,8,27,67761367,3.98,North America
1980,Arnhem,Netherlands,Netherlands,NED,33,31,36,100,78,30,108,14149800,76.33,Europe
1980,Arnhem,Netherlands,New Zealand,NZL,7,6,6,19,12,5,17,3112900,54.61,Oceania
1980,Arnhem,Netherlands,Norway,NOR,15,13,8,36,36,17,53,4085620,129.72,Europe
1980,Arnhem,Netherlands,Poland,POL,75,50,52,177,50,30,80,35574150,22.49,Europe
1980,Arnhem,Netherlands,Spain,ESP,1,13,9,23,17,7,24,37491165,6.4,Europe
1980,Arnhem,Netherlands,Sudan,SUD,1,0,0,1,8,3,11,14507466,7.58,Africa
1980,Arnhem,Netherlands,Sweden,SWE,31,36,24,91,75,19,94,8310531,113.11,Europe
1980,Arnhem,Netherlands,Switzerland,SUI,9,10,10,29,51,14,65,6319408,102.86,Europe
1980,Arnhem,Netherlands,United States of America,USA,75,66,54,195,85,47,132,227225000,5.81,North America
1992,Barcelona,Spain,Czechoslovakia,TCH,4,3,6,13,24,5,29,10319123,0.00,Europe
2012,London,Great Britain,"Congo, Dem. Rep.",COD,0,0,0,0,1,1,2,69020749,0.00,Africa
1980,Arnhem,Netherlands,Zimbabwe,ZIM,0,8,4,12,2,3,5,7408630,6.75,Africa
1984,"Stoke Mandeville, New York","Great Britain, United States of America",Argentina,ARG,0,0,0,0,6,0,6,29737097,2.02,South America
1984,"Stoke Mandeville, New York","Great Britain, United States of America",Australia,AUS,49,54,51,154,80,28,108,15544000,69.48,Oceania
1984,"Stoke Mandeville, New York","Great Britain, United States of America",Austria,AUT,14,20,10,44,37,8,45,7561434,59.51,Europe
2016,Rio de Janeiro,Brazil,"Congo, Dem. Rep.",COD,0,0,0,0,1,1,2,78789130,0.00,Africa
1984,"Stoke Mandeville, New York","Great Britain, United States of America",Bahrain,BRN,0,0,2,2,10,2,12,407233,294.67,Asia
1984,"Stoke Mandeville, New York","Great Britain, United States of America",Belgium,BEL,21,23,14,58,30,5,35,9855372,35.51,Europe
1984,"Stoke Mandeville, New York","Great Britain, United States of America",Brazil,BRA,7,17,4,28,24,6,30,132383569,2.27,South America
1964,Tokyo,Japan,Germany,FRG,0,0,0,0,0,1,1,75318337,0.00,Europe
1984,"Stoke Mandeville, New York","Great Britain, United States of America",Canada,CAN,87,82,69,238,120,46,166,25607053,64.83,North America
1984,"Stoke Mandeville, New York","Great Britain, United States of America",China,CHN,2,12,8,22,17,6,23,1036825000,0.22,Asia
1984,"Stoke Mandeville, New York","Great Britain, United States of America",Denmark,DEN,30,13,16,59,26,10,36,5111619,70.43,Europe
1968,Tel Aviv,Israel,Germany,FRG,12,12,11,35,50,8,58,77294314,0.00,Europe
1984,"Stoke Mandeville, New York","Great Britain, United States of America",Ecuador,ECU,0,0,0,0,2,0,2,8843463,2.26,South America
1984,"Stoke Mandeville, New York","Great Britain, United States of America",Egypt,EGY,1,1,5,7,25,3,28,47968643,5.84,Africa
1984,"Stoke Mandeville, New York","Great Britain, United States of America",Faroe Islands,FRO,0,0,0,0,1,2,3,44895,668.23,Europe
1984,"Stoke Mandeville, New York","Great Britain, United States of America",Finland,FIN,18,14,27,59,49,8,57,4881803,116.76,Europe
1984,"Stoke Mandeville, New York","Great Britain, United States of America",France,FRA,71,69,46,186,78,37,115,56337675,20.41,Europe
1984,"Stoke Mandeville, New York","Great Britain, United States of America",Great Britain,GBR,107,112,112,331,156,68,224,56422072,39.7,Europe
1984,"Stoke Mandeville, New York","Great Britain, United States of America",Greece,GRE,0,0,0,0,2,1,3,9895801,3.03,Europe
1984,"Stoke Mandeville, New York","Great Britain, United States of America",Guatemala,GUA,0,0,0,0,4,0,4,7669863,5.22,North America
1984,"Stoke Mandeville, New York","Great Britain, United States of America",Hong Kong,HKG,3,5,9,17,14,11,25,5397900,46.31,Asia
1984,"Stoke Mandeville, New York","Great Britain, United States of America",Hungary,HUN,12,13,3,28,22,4,26,10668095,24.37,Europe
1984,"Stoke Mandeville, New York","Great Britain, United States of America",Iceland,ISL,0,2,8,10,8,5,13,239511,542.77,Europe
1984,"Stoke Mandeville, New York","Great Britain, United States of America",India,IND,0,2,2,4,5,0,5,766833411,0.07,Asia
1984,"Stoke Mandeville, New York","Great Britain, United States of America",Indonesia,INA,0,1,1,2,6,2,8,161523353,0.5,Asia
1984,"Stoke Mandeville, New York","Great Britain, United States of America",Ireland,IRL,20,15,31,66,38,13,51,3532423,144.38,Europe
1984,"Stoke Mandeville, New York","Great Britain, United States of America",Israel,ISR,11,21,12,44,41,6,47,4159000,113.01,Asia
1984,"Stoke Mandeville, New York","Great Britain, United States of America",Italy,ITA,9,19,14,42,47,13,60,56576718,10.61,Europe
1984,"Stoke Mandeville, New York","Great Britain, United States of America",Jamaica,JAM,0,0,0,0,1,0,1,2306367,4.34,North America
1984,"Stoke Mandeville, New York","Great Britain, United States of America",Japan,JPN,9,7,8,24,27,10,37,120083000,3.08,Asia
1984,"Stoke Mandeville, New York","Great Britain, United States of America",Jordan,JOR,0,1,2,3,6,3,9,2784457,32.32,Asia
1984,"Stoke Mandeville, New York","Great Britain, United States of America",Kenya,KEN,1,1,1,3,11,2,13,19146403,6.79,Africa
1984,"Stoke Mandeville, New York","Great Britain, United States of America",Republic of Korea,KOR,0,2,2,4,15,3,18,40405956,4.45,Asia
1984,"Stoke Mandeville, New York","Great Britain, United States of America",Kuwait,KUW,1,3,4,8,20,2,22,1652150,133.16,Asia
1984,"Stoke Mandeville, New York","Great Britain, United States of America",Liechtenstein,LIE,0,0,0,0,0,1,1,27028,369.99,Europe
1984,"Stoke Mandeville, New York","Great Britain, United States of America",Luxembourg,LUX,1,4,1,6,5,0,5,365998,136.61,Europe
1984,"Stoke Mandeville, New York","Great Britain, United States of America",Malta,MLT,0,0,0,0,1,0,1,330593,30.25,Europe
1984,"Stoke Mandeville, New York","Great Britain, United States of America",Mexico,MEX,6,14,17,37,40,14,54,74352631,7.26,North America
1984,"Stoke Mandeville, New York","Great Britain, United States of America",Netherlands,NED,55,52,28,135,40,21,61,14424211,42.29,Europe
1984,"Stoke Mandeville, New York","Great Britain, United States of America",New Zealand,NZL,8,10,7,25,9,4,13,3227100,40.28,Oceania
1984,"Stoke Mandeville, New York","Great Britain, United States of America",Norway,NOR,30,30,30,90,42,22,64,4140099,154.59,Europe
1984,"Stoke Mandeville, New York","Great Britain, United States of America",Papua New Guinea,PNG,0,0,0,0,4,0,4,3975950,10.06,Oceania
1984,"Stoke Mandeville, New York","Great Britain, United States of America",Poland,POL,46,39,21,106,25,9,34,36904134,9.21,Europe
1984,"Stoke Mandeville, New York","Great Britain, United States of America",Portugal,POR,4,3,7,14,15,2,17,9996232,17.01,Europe
1984,"Stoke Mandeville, New York","Great Britain, United States of America",Spain,ESP,22,10,12,44,20,9,29,38330364,7.57,Europe
1984,"Stoke Mandeville, New York","Great Britain, United States of America",Sweden,SWE,83,43,34,160,79,18,97,8336605,116.35,Europe
1984,"Stoke Mandeville, New York","Great Britain, United States of America",Switzerland,SUI,18,13,12,43,35,8,43,6441865,66.75,Europe
1984,"Stoke Mandeville, New York","Great Britain, United States of America",Thailand,THA,0,0,0,0,4,0,4,51094870,0.78,Asia
1984,"Stoke Mandeville, New York","Great Britain, United States of America",Trinidad and Tobago,TTO,2,0,1,3,7,1,8,1155083,69.26,North America
1984,"Stoke Mandeville, New York","Great Britain, United States of America",United States of America,USA,137,131,129,397,157,79,236,235825000,10.01,North America
1984,"Stoke Mandeville, New York","Great Britain, United States of America",Venezuela,VEN,0,0,0,0,6,0,6,16876703,3.56,South America
1972,Heidelberg,Germany,Germany,FRG,28,17,22,67,52,23,75,78688452,0.00,Europe
1976,Toronto,Canada,Germany,FRG,37,34,26,97,76,17,93,78336950,0.00,Europe
1984,"Stoke Mandeville, New York","Great Britain, United States of America",Zimbabwe,ZIM,0,1,2,3,5,3,8,8562259,9.34,Africa
1988,Seoul,Republic of Korea,Argentina,ARG,0,7,2,9,18,17,35,31668939,11.05,South America
1988,Seoul,Republic of Korea,Australia,AUS,23,34,38,95,148,27,175,16532200,105.85,Oceania
1988,Seoul,Republic of Korea,Austria,AUT,13,7,15,35,37,6,43,7585317,56.69,Europe
1980,Arnhem,Netherlands,Germany,FRG,68,48,46,162,104,24,128,78288576,0.00,Europe
1988,Seoul,Republic of Korea,Bahrain,BRN,1,1,1,3,11,0,11,465198,236.46,Asia
1988,Seoul,Republic of Korea,Belgium,BEL,15,18,8,41,46,8,54,9901664,54.54,Europe
1988,Seoul,Republic of Korea,Brazil,BRA,4,9,14,27,47,12,59,143627505,4.11,South America
1988,Seoul,Republic of Korea,Bulgaria,BUL,2,1,0,3,8,0,8,8981446,8.91,Europe
1988,Seoul,Republic of Korea,Canada,CAN,55,42,55,152,104,53,157,26791747,58.6,North America
1988,Seoul,Republic of Korea,China,CHN,16,17,8,41,27,14,41,1101630000,0.37,Asia
1988,Seoul,Republic of Korea,Colombia,COL,0,0,0,0,16,0,16,31822527,5.03,South America
1988,Seoul,Republic of Korea,Cyprus,CYP,0,0,0,0,6,0,6,736476,81.47,Europe
1984,"Stoke Mandeville, New York","Great Britain, United States of America",Germany,GDR,0,3,1,4,3,1,4,,,Europe
1988,Seoul,Republic of Korea,Denmark,DEN,23,19,22,64,27,21,48,5129516,93.58,Europe
1988,Seoul,Republic of Korea,Egypt,EGY,1,3,3,7,45,1,46,53399243,8.61,Africa
1988,Seoul,Republic of Korea,Faroe Islands,FRO,1,3,3,7,1,3,4,46833,854.1,Europe
1988,Seoul,Republic of Korea,Finland,FIN,11,23,16,50,50,11,61,4946481,123.32,Europe
1988,Seoul,Republic of Korea,France,FRA,46,44,50,140,95,21,116,57627106,20.13,Europe
1988,Seoul,Republic of Korea,Great Britain,GBR,65,65,54,184,169,55,224,56928327,39.35,Europe
1988,Seoul,Republic of Korea,Greece,GRE,0,1,3,4,4,0,4,10036983,3.99,Europe
1988,Seoul,Republic of Korea,Guatemala,GUA,1,0,0,1,1,0,1,8566331,1.17,North America
1988,Seoul,Republic of Korea,Hong Kong,HKG,0,2,7,9,31,11,42,5627600,74.63,Asia
1988,Seoul,Republic of Korea,Hungary,HUN,0,5,7,12,31,3,34,10596487,32.09,Europe
1988,Seoul,Republic of Korea,Iceland,ISL,2,2,7,11,9,5,14,249740,560.58,Europe
1988,Seoul,Republic of Korea,India,IND,0,0,0,0,1,1,2,837468938,0.02,Asia
1988,Seoul,Republic of Korea,Indonesia,INA,0,2,0,2,17,2,19,174975953,1.09,Asia
1988,Seoul,Republic of Korea,Islamic Republic of Iran,IRI,4,1,3,8,36,0,36,53077312,6.78,Asia
1988,Seoul,Republic of Korea,Ireland,IRL,13,11,18,42,42,11,53,3524949,150.36,Europe
1988,Seoul,Republic of Korea,Israel,ISR,15,14,16,45,47,15,62,4442000,139.58,Asia
1988,Seoul,Republic of Korea,Italy,ITA,16,15,27,58,69,26,95,56629288,16.78,Europe
1988,Seoul,Republic of Korea,Jamaica,JAM,1,4,3,8,2,3,5,2389415,20.93,North America
1988,Seoul,Republic of Korea,Japan,JPN,17,12,17,46,109,34,143,122578000,11.67,Asia
1988,Seoul,Republic of Korea,Jordan,JOR,0,0,0,0,5,2,7,3256552,21.5,Asia
1988,Seoul,Republic of Korea,Kenya,KEN,0,4,1,5,9,3,12,22153685,5.42,Africa
1988,Seoul,Republic of Korea,Republic of Korea,KOR,40,35,19,94,205,21,226,42031247,53.77,Asia
1988,Seoul,Republic of Korea,Kuwait,KUW,5,5,7,17,27,3,30,2034850,147.43,Asia
1988,Seoul,Republic of Korea,Liechtenstein,LIE,0,0,0,0,1,1,2,28135,710.86,Europe
1984,"Stoke Mandeville, New York","Great Britain, United States of America",Germany,FRG,81,76,75,232,109,33,142,77858685,0.00,Europe
1988,Seoul,Republic of Korea,Malaysia,MAS,0,0,1,1,12,2,14,17022470,8.22,Asia
1988,Seoul,Republic of Korea,Mexico,MEX,8,9,7,24,28,5,33,80788725,4.08,North America
1988,Seoul,Republic of Korea,Morocco,MAR,0,0,1,1,14,0,14,23903592,5.86,Africa
1988,Seoul,Republic of Korea,Netherlands,NED,30,24,29,83,76,34,110,14760094,74.53,Europe
1988,Seoul,Republic of Korea,New Zealand,NZL,2,4,11,17,11,5,16,3283400,48.73,Oceania
1988,Seoul,Republic of Korea,Norway,NOR,11,11,15,37,28,6,34,4209488,80.77,Europe
1988,Seoul,Republic of Korea,Oman,OMA,0,0,0,0,9,0,9,1678119,53.63,Asia
1988,Seoul,Republic of Korea,Philippines,PHI,0,0,0,0,4,0,4,58794999,0.68,Asia
1988,Seoul,Republic of Korea,Poland,POL,23,25,33,81,39,7,46,37824487,12.16,Europe
1988,Seoul,Republic of Korea,Portugal,POR,3,5,6,14,7,6,13,10019610,12.97,Europe
1988,Seoul,Republic of Korea,Puerto Rico,PUR,1,2,0,3,12,1,13,3473898,37.42,North America
1988,Seoul,Republic of Korea,Singapore,SGP,0,0,0,0,7,1,8,2846108,28.11,Asia
1988,Seoul,Republic of Korea,Spain,ESP,18,13,12,43,42,8,50,38766939,12.9,Europe
1988,Seoul,Republic of Korea,Sweden,SWE,42,38,23,103,79,24,103,8436489,122.09,Europe
1988,Seoul,Republic of Korea,Switzerland,SUI,12,12,11,35,33,8,41,6593386,62.18,Europe
1988,Seoul,Republic of Korea,Thailand,THA,0,1,0,1,10,0,10,54891520,1.82,Asia
1988,Seoul,Republic of Korea,Trinidad and Tobago,TTO,0,0,0,0,4,0,4,1204150,33.22,North America
1988,Seoul,Republic of Korea,Tunisia,TUN,0,0,2,2,1,0,1,7880333,1.27,Africa
1988,Seoul,Republic of Korea,United States of America,USA,91,90,88,269,253,118,371,244499000,15.17,North America
1988,Seoul,Republic of Korea,Germany,FRG,76,65,52,193,145,43,188,78144619,0.00,Europe
1992,Barcelona,Spain,Independent Paralympic Participants,IPP,4,3,1,8,13,3,16,,,Others
2000,Sydney,Australia,Individual Paralympic Athletes,IPA,0,0,0,0,2,0,2,,,Others
1992,Barcelona,Spain,Algeria,ALG,0,0,0,0,8,0,8,27028330,2.96,Africa
1992,Barcelona,Spain,Argentina,ARG,1,1,0,2,26,1,27,33529320,8.05,South America
1992,Barcelona,Spain,Australia,AUS,24,27,25,76,93,41,134,17495000,76.59,Oceania
1992,Barcelona,Spain,Austria,AUT,5,4,13,22,31,5,36,7840709,45.91,Europe
1992,Barcelona,Spain,Bahrain,BRN,0,0,1,1,4,0,4,523082,76.47,Asia
1992,Barcelona,Spain,Belarus,BLR,0,0,0,0,1,0,1,10216000,0.98,Europe
1992,Barcelona,Spain,Belgium,BEL,5,5,7,17,64,9,73,10045158,72.67,Europe
1992,Barcelona,Spain,Brazil,BRA,3,0,4,7,31,10,41,154259382,2.66,South America
1992,Barcelona,Spain,Bulgaria,BUL,1,2,0,3,5,2,7,8540164,8.2,Europe
1992,Barcelona,Spain,Burkina Faso,BUR,0,0,0,0,3,0,3,9297110,3.23,Africa
1992,Barcelona,Spain,Canada,CAN,28,21,26,75,89,49,138,28371264,48.64,North America
1992,Barcelona,Spain,Chile,CHI,0,0,0,0,2,0,2,13719818,1.46,South America
1992,Barcelona,Spain,China,CHN,11,7,7,25,13,11,24,1164970000,0.21,Asia
2016,Rio de Janeiro,Brazil,Individual Paralympic Athletes,IPA,0,0,0,0,2,0,2,,,Others
1992,Barcelona,Spain,Colombia,COL,0,0,0,0,4,2,6,34422568,1.74,South America
1992,Barcelona,Spain,Costa Rica,CRC,0,0,0,0,2,0,2,3286525,6.09,North America
1992,Barcelona,Spain,Croatia,CRO,0,0,1,1,5,1,6,4575818,13.11,Europe
1992,Barcelona,Spain,Cuba,CUB,3,3,3,9,10,0,10,10736386,9.31,North America
1992,Barcelona,Spain,Cyprus,CYP,0,0,0,0,4,0,4,800610,49.96,Europe
2012,London,Great Britain,"Korea, Dem. People's Rep.",PRK,0,0,0,0,1,0,1,24800638,0.00,Asia
1992,Barcelona,Spain,Denmark,DEN,12,22,12,46,22,21,43,5171370,83.15,Europe
1992,Barcelona,Spain,Dominican Republic,DOM,0,0,0,0,1,0,1,7408339,1.35,North America
1992,Barcelona,Spain,Ecuador,ECU,0,0,0,0,3,0,3,10716131,2.8,South America
1992,Barcelona,Spain,Egypt,EGY,7,6,7,20,41,0,41,58666812,6.99,Africa
1992,Barcelona,Spain,Estonia,EST,0,2,1,3,2,4,6,1533091,39.14,Europe
1992,Barcelona,Spain,Faroe Islands,FRO,0,1,0,1,1,2,3,46746,641.77,Europe
1992,Barcelona,Spain,Finland,FIN,8,6,11,25,54,13,67,5041992,132.88,Europe
1992,Barcelona,Spain,France,FRA,36,36,34,106,106,39,145,58851216,24.64,Europe
1992,Barcelona,Spain,Germany,GER,61,51,59,171,174,64,238,80624598,29.52,Europe
1992,Barcelona,Spain,Great Britain,GBR,40,47,41,128,156,52,208,57580402,36.12,Europe
1992,Barcelona,Spain,Greece,GRE,0,2,1,3,7,0,7,10399061,6.73,Europe
1992,Barcelona,Spain,Hong Kong,HKG,3,4,4,11,16,5,21,5800500,36.2,Asia
1992,Barcelona,Spain,Hungary,HUN,4,3,4,11,34,9,43,10369341,41.47,Europe
1992,Barcelona,Spain,Iceland,ISL,3,2,12,17,8,4,12,261057,459.67,Europe
2016,Rio de Janeiro,Brazil,"Korea, Dem. People's Rep.",PRK,0,0,0,0,1,1,2,25307665,0.00,Asia
1992,Barcelona,Spain,India,IND,0,0,0,0,7,2,9,909307018,0.1,Asia
1992,Barcelona,Spain,Islamic Republic of Iran,IRI,1,2,1,4,25,4,29,58780376,4.93,Asia
1992,Barcelona,Spain,Iraq,IRQ,0,0,1,1,18,0,18,18402740,9.78,Asia
1992,Barcelona,Spain,Ireland,IRL,0,3,4,7,40,18,58,3558430,162.99,Europe
1992,Barcelona,Spain,Israel,ISR,2,4,5,11,56,6,62,5123000,121.02,Asia
1992,Barcelona,Spain,Italy,ITA,10,7,18,35,69,18,87,56797087,15.32,Europe
1992,Barcelona,Spain,Jamaica,JAM,0,1,2,3,2,2,4,2461047,16.25,North America
1992,Barcelona,Spain,Japan,JPN,8,7,15,30,54,22,76,124425000,6.11,Asia
1992,Barcelona,Spain,Kenya,KEN,1,0,1,2,9,6,15,25326080,5.92,Africa
1992,Barcelona,Spain,Republic of Korea,KOR,11,15,18,44,64,2,66,43747962,15.09,Asia
1992,Barcelona,Spain,Kuwait,KUW,1,3,1,5,21,3,24,,,Asia
1992,Barcelona,Spain,Latvia,LAT,0,0,0,0,2,0,2,2614338,7.65,Europe
1992,Barcelona,Spain,Liechtenstein,LIE,0,0,0,0,3,0,3,29552,"1,015.16",Europe
1992,Barcelona,Spain,Lithuania,LTU,0,4,3,7,1,3,4,3700114,10.81,Europe
1992,Barcelona,Spain,Luxembourg,LUX,0,0,0,0,2,0,2,392175,51,Europe
1988,Seoul,Republic of Korea,Macao,MAC,0,0,0,0,6,1,7,320774,0.00,Asia
1992,Barcelona,Spain,Malaysia,MAS,0,1,2,3,10,0,10,19002660,5.26,Asia
1992,Barcelona,Spain,Mexico,MEX,0,1,10,11,9,10,19,87075136,2.18,North America
1992,Barcelona,Spain,Morocco,MAR,0,0,0,0,5,0,5,25711410,1.94,Africa
1992,Barcelona,Spain,Myanmar,MYA,0,0,0,0,1,0,1,42401686,0.24,Asia
1992,Barcelona,Spain,Namibia,NAM,0,0,0,0,0,2,2,1516951,13.18,Africa
1992,Barcelona,Spain,Netherlands,NED,14,14,11,39,72,27,99,15184166,65.2,Europe
1992,Barcelona,Spain,New Zealand,NZL,5,1,0,6,9,4,13,3531700,36.81,Oceania
1992,Barcelona,Spain,Nigeria,NGR,3,0,0,3,6,0,6,100161708,0.6,Africa
1992,Barcelona,Spain,Norway,NOR,13,13,7,33,33,5,38,4286401,88.65,Europe
1992,Barcelona,Spain,Oman,OMA,0,0,0,0,4,0,4,1983272,20.17,Asia
1992,Barcelona,Spain,Pakistan,PAK,0,0,0,0,2,0,2,113911126,0.18,Asia
1992,Barcelona,Spain,Panama,PAN,1,2,0,3,2,0,2,2575949,7.76,North America
1992,Barcelona,Spain,Poland,POL,10,12,10,32,36,4,40,38363667,10.43,Europe
1992,Barcelona,Spain,Portugal,POR,3,3,3,9,26,4,30,9952494,30.14,Europe
1992,Barcelona,Spain,Puerto Rico,PUR,0,0,0,0,8,1,9,3585176,25.1,North America
1992,Barcelona,Spain,Seychelles,SEY,0,0,0,0,2,0,2,70763,282.63,Africa
1992,Barcelona,Spain,Singapore,SGP,0,0,0,0,3,1,4,3230698,12.38,Asia
1992,Barcelona,Spain,Slovenia,SLO,2,0,1,3,7,1,8,1996498,40.07,Europe
1992,Barcelona,Spain,South Africa,RSA,4,1,3,8,9,1,10,38672611,2.59,Africa
1992,Barcelona,Spain,Spain,ESP,34,31,42,107,167,66,233,39157685,59.5,Europe
1992,Barcelona,Spain,Sweden,SWE,7,22,9,38,72,27,99,8668067,114.21,Europe
1992,Barcelona,Spain,Switzerland,SUI,6,16,13,35,36,5,41,6875364,59.63,Europe
1992,Barcelona,Spain,Syrian Arab Republic,SYR,0,0,0,0,2,0,2,13187669,1.52,Asia
1992,Barcelona,Spain,Macao,MAC,0,0,0,0,2,0,2,362308,0.00,Asia
1992,Barcelona,Spain,Thailand,THA,0,0,1,1,5,0,5,57811025,0.86,Asia
1992,Barcelona,Spain,Tunisia,TUN,0,0,0,0,1,0,1,8613855,1.16,Africa
1992,Barcelona,Spain,Turkey,TUR,0,0,0,0,1,0,1,55748946,0.18,Europe
1996,Atlanta,United States of America,Macao,MAC,0,0,0,0,1,0,1,393376,0.00,Asia
1992,Barcelona,Spain,United Arab Emirates,UAE,0,0,0,0,1,0,1,2052892,4.87,Asia
1992,Barcelona,Spain,United States of America,USA,75,52,48,175,264,90,354,256514000,13.8,North America
1992,Barcelona,Spain,Uruguay,URU,0,0,0,0,2,0,2,3154459,6.34,South America
1992,Barcelona,Spain,Venezuela,VEN,0,0,1,1,9,1,10,20557694,4.86,South America
1992,Barcelona,Spain,Yemen,YEM,0,0,0,0,3,0,3,12954157,2.32,Asia
1996,Atlanta,United States of America,Afghanistan,AFG,0,0,0,0,2,0,2,18853444,1.06,Asia
1996,Atlanta,United States of America,Algeria,ALG,2,2,3,7,9,0,9,29266415,3.08,Africa
1996,Atlanta,United States of America,Angola,ANG,0,0,0,0,2,0,2,14400722,1.39,Africa
1996,Atlanta,United States of America,Argentina,ARG,2,5,2,9,49,7,56,35246376,15.89,South America
1996,Atlanta,United States of America,Armenia,ARM,0,0,0,0,5,0,5,3168213,15.78,Europe
1996,Atlanta,United States of America,Australia,AUS,42,37,27,106,99,62,161,18311000,87.93,Oceania
1996,Atlanta,United States of America,Austria,AUT,6,6,10,22,44,5,49,7959017,61.57,Europe
1996,Atlanta,United States of America,Azerbaijan,AZE,0,0,0,0,2,0,2,7763000,2.58,Europe
1996,Atlanta,United States of America,Bahrain,BRN,0,0,0,0,6,0,6,578661,103.69,Asia
1996,Atlanta,United States of America,Belarus,BLR,3,3,7,13,11,4,15,10160000,14.76,Europe
1996,Atlanta,United States of America,Belgium,BEL,8,10,7,25,32,6,38,10156637,37.41,Europe
1996,Atlanta,United States of America,Bermuda,BER,0,0,0,0,0,2,2,60129,332.62,North America
1996,Atlanta,United States of America,Bosnia and Herzegovina,BIH,0,0,0,0,3,0,3,3764419,7.97,Europe
1996,Atlanta,United States of America,Brazil,BRA,2,6,13,21,41,19,60,164614682,3.64,South America
1996,Atlanta,United States of America,Bulgaria,BUL,0,1,1,2,4,2,6,8362826,7.17,Europe
1996,Atlanta,United States of America,Burkina Faso,BUR,0,0,0,0,3,0,3,10372734,2.89,Africa
1996,Atlanta,United States of America,Canada,CAN,24,21,24,69,94,38,132,29610218,44.58,North America
1996,Atlanta,United States of America,Chile,CHI,0,0,0,0,2,0,2,14587367,1.37,South America
1996,Atlanta,United States of America,China,CHN,16,13,10,39,27,10,37,1217550000,0.3,Asia
2000,Sydney,Australia,Macao,MAC,0,0,0,0,1,1,2,427772,0.00,Asia
1996,Atlanta,United States of America,Colombia,COL,0,0,0,0,2,0,2,37076387,0.54,South America
2004,Athens,Greece,Macao,MAC,0,0,0,0,1,0,1,471600,0.00,Asia
1996,Atlanta,United States of America,Croatia,CRO,0,0,0,0,2,3,5,4557097,10.97,Europe
1996,Atlanta,United States of America,Cuba,CUB,8,3,0,11,9,1,10,10939285,9.14,North America
1996,Atlanta,United States of America,Cyprus,CYP,0,0,0,0,4,0,4,873426,45.8,Europe
1996,Atlanta,United States of America,Czech Republic,CZE,2,7,1,10,36,7,43,10315241,41.69,Europe
1996,Atlanta,United States of America,Denmark,DEN,7,17,17,41,25,20,45,5263074,85.5,Europe
1996,Atlanta,United States of America,Dominican Republic,DOM,1,0,0,1,2,0,2,7952766,2.51,North America
1996,Atlanta,United States of America,Ecuador,ECU,0,0,0,0,2,0,2,11703169,1.71,South America
1996,Atlanta,United States of America,Egypt,EGY,8,11,11,30,26,5,31,63601632,4.87,Africa
1996,Atlanta,United States of America,Estonia,EST,3,4,2,9,2,8,10,1415594,70.64,Europe
1996,Atlanta,United States of America,Faroe Islands,FRO,0,0,0,0,0,1,1,45624,219.18,Europe
1996,Atlanta,United States of America,Fiji,FIJ,0,0,0,0,2,0,2,784389,25.5,Oceania
1996,Atlanta,United States of America,Finland,FIN,4,5,4,13,53,12,65,5124573,126.84,Europe
1996,Atlanta,United States of America,France,FRA,35,29,31,95,122,25,147,59753095,24.6,Europe
1996,Atlanta,United States of America,Germany,GER,40,58,51,149,153,78,231,81914831,28.2,Europe
1996,Atlanta,United States of America,Great Britain,GBR,39,42,41,122,165,83,248,58166950,42.64,Europe
1996,Atlanta,United States of America,Greece,GRE,1,1,3,5,16,0,16,10608800,15.08,Europe
1996,Atlanta,United States of America,Honduras,HON,0,0,0,0,2,0,2,5874814,3.4,North America
1996,Atlanta,United States of America,Hong Kong,HKG,5,5,5,15,19,5,24,6435500,37.29,Asia
1996,Atlanta,United States of America,Hungary,HUN,5,2,3,10,32,10,42,10311238,40.73,Europe
1996,Atlanta,United States of America,Iceland,ISL,5,4,5,14,6,4,10,268916,371.86,Europe
1996,Atlanta,United States of America,India,IND,0,0,0,0,9,0,9,982365248,0.09,Asia
1996,Atlanta,United States of America,Indonesia,INA,0,0,0,0,1,0,1,199901231,0.05,Asia
1996,Atlanta,United States of America,Islamic Republic of Iran,IRI,9,5,3,17,28,2,30,62294919,4.82,Asia
1996,Atlanta,United States of America,Ireland,IRL,1,3,6,10,46,17,63,3637510,173.2,Europe
1996,Atlanta,United States of America,Israel,ISR,0,4,5,9,37,3,40,5692000,70.27,Asia
1996,Atlanta,United States of America,Italy,ITA,11,20,14,45,59,19,78,56860281,13.72,Europe
1996,Atlanta,United States of America,Jamaica,JAM,0,0,1,1,2,1,3,2558631,11.73,North America
1996,Atlanta,United States of America,Japan,JPN,14,10,13,37,58,23,81,125757000,6.44,Asia
1996,Atlanta,United States of America,Jordan,JOR,0,1,0,1,5,0,5,4732848,10.56,Asia
1996,Atlanta,United States of America,Kazakhstan,KAZ,0,0,0,0,13,0,13,15578227,8.34,Europe
1996,Atlanta,United States of America,Kenya,KEN,1,1,0,2,11,6,17,28589456,5.95,Africa
1996,Atlanta,United States of America,Republic of Korea,KOR,13,2,15,30,55,9,64,45524681,14.06,Asia
1996,Atlanta,United States of America,Kuwait,KUW,1,1,1,3,17,0,17,1626858,104.5,Asia
1996,Atlanta,United States of America,Kyrgyzstan,KGZ,0,0,0,0,2,0,2,4628400,4.32,Asia
1996,Atlanta,United States of America,Latvia,LAT,0,0,0,0,4,1,5,2457222,20.35,Europe
1996,Atlanta,United States of America,Libya,LBA,0,0,0,0,4,0,4,5036173,7.94,Africa
1996,Atlanta,United States of America,Lithuania,LTU,3,2,6,11,6,3,9,3601613,24.99,Europe
1996,Atlanta,United States of America,Luxembourg,LUX,0,0,0,0,1,0,1,414225,24.14,Europe
2008,Beijing,China,Macao,MAC,0,0,0,0,1,1,2,515232,0.00,Asia
1996,Atlanta,United States of America,Malaysia,MAS,0,0,0,0,6,0,6,21017619,2.85,Asia
1996,Atlanta,United States of America,Mauritius,MRI,0,0,0,0,2,0,2,1133996,17.64,Africa
1996,Atlanta,United States of America,Mexico,MEX,3,5,4,12,28,10,38,93147045,4.08,North America
1996,Atlanta,United States of America,Republic of Moldova,MDA,0,0,2,2,5,0,5,2946401,16.97,Europe
1996,Atlanta,United States of America,Morocco,MAR,0,0,0,0,4,0,4,27383472,1.46,Africa
1996,Atlanta,United States of America,Netherlands,NED,17,11,17,45,73,33,106,15530498,68.25,Europe
1996,Atlanta,United States of America,New Zealand,NZL,9,6,3,18,28,6,34,3732000,91.1,Oceania
1996,Atlanta,United States of America,Nigeria,NGR,3,2,3,8,8,0,8,110668784,0.72,Africa
1996,Atlanta,United States of America,North Macedonia,MKD,0,0,0,0,1,0,1,1989441,5.03,Europe
1996,Atlanta,United States of America,Norway,NOR,9,7,4,20,35,7,42,4381336,95.86,Europe
1996,Atlanta,United States of America,Oman,OMA,0,0,0,0,3,0,3,2236652,13.41,Asia
1996,Atlanta,United States of America,Pakistan,PAK,0,0,0,0,1,0,1,127349293,0.08,Asia
1996,Atlanta,United States of America,Panama,PAN,2,0,0,2,1,0,1,2796291,3.58,North America
1996,Atlanta,United States of America,Peru,PER,1,0,0,1,3,0,3,24753825,1.21,South America
1996,Atlanta,United States of America,Poland,POL,13,14,8,35,49,12,61,38624370,15.79,Europe
1996,Atlanta,United States of America,Portugal,POR,6,4,4,14,29,6,35,10063945,34.78,Europe
1996,Atlanta,United States of America,Puerto Rico,PUR,0,0,0,0,3,2,5,3724655,13.42,North America
1996,Atlanta,United States of America,Qatar,QAT,0,0,0,0,1,0,1,522531,19.14,Asia
1996,Atlanta,United States of America,Romania,ROU,0,0,0,0,1,0,1,22619004,0.44,Europe
2012,London,Great Britain,Macao,MAC,0,0,0,0,1,1,2,564037,0.00,Asia
1996,Atlanta,United States of America,Saudi Arabia,KSA,0,0,0,0,2,0,2,19033843,1.05,Asia
2016,Rio de Janeiro,Brazil,Macao,MAC,0,0,0,0,1,0,1,612824,0.00,Asia
1996,Atlanta,United States of America,Sierra Leone,SLE,0,0,0,0,1,0,1,4312660,2.32,Africa
1996,Atlanta,United States of America,Singapore,SGP,0,0,0,0,1,2,3,3670704,8.17,Asia
1996,Atlanta,United States of America,Slovakia,SVK,2,4,5,11,23,5,28,5373361,52.11,Europe
1996,Atlanta,United States of America,Slovenia,SLO,0,2,3,5,13,1,14,1988628,70.4,Europe
1996,Atlanta,United States of America,South Africa,RSA,10,8,10,28,29,11,40,42241007,9.47,Africa
1996,Atlanta,United States of America,Spain,ESP,39,31,36,106,146,50,196,39889852,49.14,Europe
1996,Atlanta,United States of America,Sri Lanka,SRI,0,0,0,0,1,0,1,18367290,0.54,Asia
1996,Atlanta,United States of America,Sweden,SWE,12,14,11,37,83,27,110,8840998,124.42,Europe
1996,Atlanta,United States of America,Switzerland,SUI,9,6,6,21,36,9,45,7071850,63.63,Europe
1996,Atlanta,United States of America,Syrian Arab Republic,SYR,0,0,0,0,2,0,2,14754148,1.36,Asia
1996,Atlanta,United States of America,Thailand,THA,0,0,2,2,7,0,7,60130190,1.16,Asia
1996,Atlanta,United States of America,Tunisia,TUN,0,2,0,2,2,1,3,9267335,3.24,Africa
1996,Atlanta,United States of America,Uganda,UGA,0,0,0,0,1,0,1,21032817,0.48,Africa
1996,Atlanta,United States of America,Ukraine,UKR,1,4,2,7,25,5,30,51057800,5.88,Europe
1996,Atlanta,United States of America,United Arab Emirates,UAE,0,0,0,0,5,0,5,2539121,19.69,Asia
1996,Atlanta,United States of America,United States of America,USA,46,46,65,157,239,89,328,269394000,12.18,North America
1996,Atlanta,United States of America,Uruguay,URU,0,0,1,1,1,0,1,3247383,3.08,South America
1996,Atlanta,United States of America,Venezuela,VEN,0,0,0,0,4,0,4,22385650,1.79,South America
1976,Toronto,Canada,Myanmar,MYA,1,1,1,3,4,0,4,31314347,0.00,Asia
1996,Atlanta,United States of America,Zambia,ZAM,0,0,0,0,1,0,1,9339740,1.07,Africa
1996,Atlanta,United States of America,Zimbabwe,ZIM,0,0,0,0,2,0,2,11541215,1.73,Africa
2000,Sydney,Australia,Algeria,ALG,3,0,0,3,7,1,8,31042238,2.58,Africa
2000,Sydney,Australia,Angola,ANG,0,0,0,0,1,0,1,16395477,0.61,Africa
2000,Sydney,Australia,Argentina,ARG,0,2,3,5,31,12,43,36870796,11.66,South America
2000,Sydney,Australia,Armenia,ARM,0,0,0,0,4,0,4,3069597,13.03,Europe
2000,Sydney,Australia,Australia,AUS,63,39,47,149,193,93,286,19153000,149.32,Oceania
2000,Sydney,Australia,Austria,AUT,2,7,6,15,47,5,52,8011566,64.91,Europe
2000,Sydney,Australia,Azerbaijan,AZE,0,1,0,1,6,1,7,8048600,8.7,Europe
2000,Sydney,Australia,Bahrain,BRN,0,1,1,2,3,0,3,664610,45.14,Asia
2000,Sydney,Australia,Barbados,BAR,0,0,0,0,1,0,1,271511,36.83,North America
2000,Sydney,Australia,Belarus,BLR,5,8,10,23,15,7,22,9979610,22.04,Europe
2000,Sydney,Australia,Belgium,BEL,1,4,4,9,25,5,30,10251250,29.26,Europe
2000,Sydney,Australia,Benin,BEN,0,0,0,0,1,0,1,6865946,1.46,Africa
2000,Sydney,Australia,Bermuda,BER,0,0,0,0,1,1,2,61833,323.45,North America
2000,Sydney,Australia,Bosnia and Herzegovina,BIH,0,1,0,1,13,0,13,3751176,34.66,Europe
2000,Sydney,Australia,Brazil,BRA,6,10,6,22,52,11,63,174790339,3.6,South America
2000,Sydney,Australia,Bulgaria,BUL,1,0,0,1,3,1,4,8170172,4.9,Europe
2000,Sydney,Australia,Burkina Faso,BUR,0,0,0,0,1,0,1,11607951,0.86,Africa
2000,Sydney,Australia,Cambodia,CAM,0,0,0,0,11,0,11,12155241,9.05,Asia
2000,Sydney,Australia,Canada,CAN,38,33,25,96,112,53,165,30685730,53.77,North America
2000,Sydney,Australia,Chile,CHI,0,0,0,0,4,0,4,15342350,2.61,South America
2000,Sydney,Australia,China,CHN,34,22,17,73,54,33,87,1262645000,0.69,Asia
1984,"Stoke Mandeville, New York","Great Britain, United States of America",Myanmar,MYA,1,2,1,4,10,0,10,37241530,0.00,Asia
2000,Sydney,Australia,Colombia,COL,0,0,0,0,3,0,3,39629965,0.76,South America
2000,Sydney,Australia,Costa Rica,CRC,0,0,0,0,1,0,1,3962369,2.52,North America
2000,Sydney,Australia,Palestine,PLE,0,0,1,1,1,1,2,,,Asia
2000,Sydney,Australia,Croatia,CRO,0,0,0,0,10,5,15,4468302,33.57,Europe
2000,Sydney,Australia,Cuba,CUB,4,2,2,8,9,1,10,11126423,8.99,North America
2000,Sydney,Australia,Cyprus,CYP,0,0,0,0,3,1,4,943288,42.4,Europe
2000,Sydney,Australia,Czech Republic,CZE,15,15,13,43,41,16,57,10255063,55.58,Europe
2000,Sydney,Australia,Denmark,DEN,8,8,14,30,26,12,38,5339616,71.17,Europe
2000,Sydney,Australia,Ecuador,ECU,0,0,0,0,2,1,3,12681123,2.37,South America
2000,Sydney,Australia,Egypt,EGY,6,12,10,28,33,12,45,68831561,6.54,Africa
2000,Sydney,Australia,El Salvador,ESA,0,0,0,0,0,1,1,5887930,1.7,North America
2000,Sydney,Australia,Estonia,EST,1,1,3,5,4,6,10,1396985,71.58,Europe
2000,Sydney,Australia,Faroe Islands,FRO,0,3,1,4,0,2,2,46738,427.92,Europe
2000,Sydney,Australia,Fiji,FIJ,0,0,0,0,4,0,4,811011,49.32,Oceania
2000,Sydney,Australia,Finland,FIN,1,3,6,10,38,11,49,5176209,94.66,Europe
2000,Sydney,Australia,France,FRA,30,28,28,86,116,30,146,60912500,23.97,Europe
2000,Sydney,Australia,Germany,GER,16,41,38,95,181,69,250,82211508,30.41,Europe
2000,Sydney,Australia,Great Britain,GBR,41,43,47,131,140,74,214,58892514,36.34,Europe
2000,Sydney,Australia,Greece,GRE,4,4,3,11,41,3,44,10805808,40.72,Europe
2000,Sydney,Australia,Honduras,HON,0,0,0,0,1,0,1,6574510,1.52,North America
2000,Sydney,Australia,Hong Kong,HKG,8,3,7,18,22,6,28,6665000,42.01,Asia
2000,Sydney,Australia,Hungary,HUN,4,5,14,23,41,13,54,10210971,52.88,Europe
2000,Sydney,Australia,Iceland,ISL,2,0,2,4,5,1,6,281205,213.37,Europe
2000,Sydney,Australia,India,IND,0,0,0,0,4,0,4,1056575548,0.04,Asia
2004,Athens,Greece,Palestine,PLE,0,1,1,2,2,0,2,,,Asia
2000,Sydney,Australia,Indonesia,INA,0,0,0,0,4,0,4,211513822,0.19,Asia
2000,Sydney,Australia,Islamic Republic of Iran,IRI,12,4,7,23,36,4,40,65623397,6.1,Asia
2000,Sydney,Australia,Iraq,IRQ,0,0,0,0,3,0,3,23497589,1.28,Asia
2000,Sydney,Australia,Ireland,IRL,5,3,1,9,23,15,38,3805174,99.86,Europe
2000,Sydney,Australia,Israel,ISR,3,2,1,6,31,2,33,6289000,52.47,Asia
2000,Sydney,Australia,Italy,ITA,9,8,10,27,50,16,66,56942108,11.59,Europe
2000,Sydney,Australia,Jamaica,JAM,0,0,0,0,3,2,5,2654698,18.83,North America
2000,Sydney,Australia,Japan,JPN,13,17,11,41,111,40,151,126843000,11.9,Asia
2000,Sydney,Australia,Jordan,JOR,1,0,0,1,5,2,7,5122495,13.67,Asia
2000,Sydney,Australia,Kazakhstan,KAZ,0,0,0,0,2,0,2,14883626,1.34,Europe
2000,Sydney,Australia,Kenya,KEN,1,1,2,4,8,5,13,31964557,4.07,Africa
2000,Sydney,Australia,Republic of Korea,KOR,18,7,7,32,82,7,89,47008111,18.93,Asia
2000,Sydney,Australia,Kuwait,KUW,0,1,4,5,22,4,26,2045123,127.13,Asia
2000,Sydney,Australia,Kyrgyzstan,KGZ,0,0,0,0,2,0,2,4898400,4.08,Asia
2000,Sydney,Australia,Lao People's Democratic Republic,LAO,0,0,0,0,1,1,2,5323701,3.76,Asia
2000,Sydney,Australia,Latvia,LAT,0,0,3,3,4,1,5,2367550,21.12,Europe
2000,Sydney,Australia,Lebanon,LBN,0,0,0,0,2,0,2,3842774,5.2,Asia
2000,Sydney,Australia,Lesotho,LES,0,0,0,0,1,1,2,2032805,9.84,Africa
2000,Sydney,Australia,Libya,LBA,0,0,1,1,16,1,17,5357893,31.73,Africa
2000,Sydney,Australia,Lithuania,LTU,0,2,1,3,14,3,17,3499536,48.58,Europe
2008,Beijing,China,Palestine,PLE,0,0,0,0,2,0,2,,,Asia
2000,Sydney,Australia,Madagascar,MAD,0,0,0,0,1,0,1,15766806,0.63,Africa
2000,Sydney,Australia,Malaysia,MAS,0,0,0,0,8,2,10,23194252,4.31,Asia
2000,Sydney,Australia,Mali,MLI,0,0,0,0,1,0,1,10946448,0.91,Africa
2000,Sydney,Australia,Mauritania,MTN,0,0,0,0,1,1,2,2630217,7.6,Africa
2000,Sydney,Australia,Mexico,MEX,10,12,12,34,48,29,77,98899845,7.79,North America
2000,Sydney,Australia,Republic of Moldova,MDA,0,0,0,0,6,0,6,2923783,20.52,Europe
2000,Sydney,Australia,Mongolia,MGL,0,0,0,0,2,0,2,2397417,8.34,Asia
2000,Sydney,Australia,Morocco,MAR,0,0,0,0,5,2,7,28793672,2.43,Africa
2000,Sydney,Australia,Netherlands,NED,12,9,9,30,68,33,101,15925513,63.42,Europe
2000,Sydney,Australia,New Zealand,NZL,6,8,4,18,36,6,42,3857700,108.87,Oceania
2000,Sydney,Australia,Nigeria,NGR,7,1,5,13,18,11,29,122283853,2.37,Africa
2000,Sydney,Australia,North Macedonia,MKD,0,0,0,0,2,0,2,2034823,9.83,Europe
2000,Sydney,Australia,Norway,NOR,2,6,7,15,26,13,39,4490967,86.84,Europe
2000,Sydney,Australia,Oman,OMA,0,0,0,0,3,0,3,2267973,13.23,Asia
2000,Sydney,Australia,Pakistan,PAK,0,0,0,0,1,0,1,142343583,0.07,Asia
2012,London,Great Britain,Palestine,PLE,0,0,0,0,2,0,2,,,Asia
2000,Sydney,Australia,Panama,PAN,0,1,1,2,1,0,1,3030333,3.3,North America
2000,Sydney,Australia,Papua New Guinea,PNG,0,0,0,0,3,0,3,5847590,5.13,Oceania
2000,Sydney,Australia,Peru,PER,1,1,0,2,3,1,4,26459944,1.51,South America
2000,Sydney,Australia,Philippines,PHI,0,0,1,1,1,1,2,77991757,0.26,Asia
2000,Sydney,Australia,Poland,POL,19,22,12,53,86,27,113,38258629,29.54,Europe
2000,Sydney,Australia,Portugal,POR,6,5,4,15,45,7,52,10289898,50.54,Europe
2000,Sydney,Australia,Puerto Rico,PUR,0,0,1,1,1,2,3,3810605,7.87,North America
2000,Sydney,Australia,Qatar,QAT,0,0,0,0,3,0,3,592467,50.64,Asia
2000,Sydney,Australia,Romania,ROU,0,0,0,0,1,0,1,22442971,0.45,Europe
2016,Rio de Janeiro,Brazil,Palestine,PLE,0,0,0,0,1,0,1,,,Asia
2000,Sydney,Australia,Rwanda,RWA,0,0,0,0,1,0,1,7933688,1.26,Africa
2000,Sydney,Australia,Samoa,SAM,0,0,0,0,1,0,1,174454,57.32,Oceania
2000,Sydney,Australia,Saudi Arabia,KSA,0,0,0,0,4,0,4,20663840,1.94,Asia
2020,Tokyo,Japan,Palestine,PLE,0,0,0,0,1,0,1,,,Asia
2000,Sydney,Australia,Singapore,SGP,0,0,0,0,1,2,3,4027887,7.45,Asia
2000,Sydney,Australia,Slovakia,SVK,3,5,5,13,34,11,45,5388720,83.51,Europe
2000,Sydney,Australia,Slovenia,SLO,0,2,2,4,15,2,17,1988925,85.47,Europe
2000,Sydney,Australia,South Africa,RSA,13,12,13,38,50,16,66,44967713,14.68,Africa
2000,Sydney,Australia,Spain,ESP,38,30,38,106,157,52,209,40567864,51.52,Europe
2000,Sydney,Australia,Sri Lanka,SRI,0,0,0,0,3,0,3,18777606,1.6,Asia
2000,Sydney,Australia,Sweden,SWE,5,6,10,21,70,17,87,8872109,98.06,Europe
2000,Sydney,Australia,Switzerland,SUI,8,4,8,20,44,9,53,7184250,73.77,Europe
2000,Sydney,Australia,Syrian Arab Republic,SYR,0,0,0,0,3,1,4,16410847,2.44,Asia
2000,Sydney,Australia,Thailand,THA,5,4,2,11,35,6,41,62952639,6.51,Asia
2000,Sydney,Australia,Tonga,TGA,0,0,0,0,0,1,1,97962,102.08,Oceania
2000,Sydney,Australia,Tunisia,TUN,6,4,1,11,8,2,10,9708347,10.3,Africa
2000,Sydney,Australia,Turkey,TUR,0,0,0,0,1,0,1,63240196,0.16,Europe
2000,Sydney,Australia,Turkmenistan,TKM,0,0,0,0,1,0,1,4516128,2.21,Asia
2000,Sydney,Australia,Uganda,UGA,0,0,0,0,0,1,1,23650159,0.42,Africa
2000,Sydney,Australia,Ukraine,UKR,3,20,14,37,49,18,67,49176500,13.62,Europe
2000,Sydney,Australia,United Arab Emirates,UAE,0,3,1,4,14,0,14,3134067,44.67,Asia
2000,Sydney,Australia,United States of America,USA,36,39,34,109,181,86,267,282162411,9.46,North America
2000,Sydney,Australia,Uruguay,URU,0,0,0,0,1,1,2,3319734,6.02,South America
2000,Sydney,Australia,Vanuatu,VAN,0,0,0,0,1,1,2,184964,108.13,Oceania
2000,Sydney,Australia,Venezuela,VEN,0,0,1,1,8,2,10,24192449,4.13,South America
2000,Sydney,Australia,Vietnam,VIE,0,0,0,0,1,1,2,79910411,0.25,Asia
2020,Tokyo,Japan,Refugee Paralympic Team,RPT,0,0,0,0,5,1,6,,,Others
2000,Sydney,Australia,Zambia,ZAM,0,0,0,0,1,1,2,10415942,1.92,Africa
2000,Sydney,Australia,Zimbabwe,ZIM,1,0,0,1,2,1,3,11881482,2.52,Africa
2004,Athens,Greece,Afghanistan,AFG,0,0,0,0,1,2,3,24726689,1.21,Asia
2004,Athens,Greece,Algeria,ALG,6,2,5,13,14,4,18,32692153,5.51,Africa
2004,Athens,Greece,Angola,ANG,3,0,0,3,3,1,4,18758138,2.13,Africa
2004,Athens,Greece,Argentina,ARG,0,2,2,4,42,11,53,38491970,13.77,South America
2004,Athens,Greece,Armenia,ARM,0,0,0,0,1,1,2,3000715,6.67,Europe
2004,Athens,Greece,Australia,AUS,26,39,36,101,89,56,145,20127400,72.04,Oceania
2004,Athens,Greece,Austria,AUT,8,10,4,22,40,4,44,8171966,53.84,Europe
2004,Athens,Greece,Azerbaijan,AZE,2,1,1,4,8,1,9,8306500,10.83,Europe
2004,Athens,Greece,Bahrain,BRN,0,1,0,1,5,0,5,829846,60.25,Asia
2004,Athens,Greece,Bangladesh,BAN,0,0,0,0,1,0,1,136986429,0.07,Asia
2004,Athens,Greece,Barbados,BAR,0,0,0,0,1,0,1,275283,36.33,North America
2004,Athens,Greece,Belarus,BLR,10,12,7,29,19,11,30,9730146,30.83,Europe
2004,Athens,Greece,Belgium,BEL,3,2,2,7,24,1,25,10421137,23.99,Europe
2004,Athens,Greece,Benin,BEN,0,0,0,0,1,1,2,7750003,2.58,Africa
2004,Athens,Greece,Bermuda,BER,0,0,0,0,0,2,2,63740,313.77,North America
2004,Athens,Greece,Bosnia and Herzegovina,BIH,1,0,0,1,15,0,15,3764194,39.85,Europe
2004,Athens,Greece,Botswana,BOT,1,0,0,1,0,1,1,1765533,5.66,Africa
2004,Athens,Greece,Brazil,BRA,14,12,7,33,72,22,94,184006479,5.11,South America
2004,Athens,Greece,Bulgaria,BUL,0,0,0,0,6,3,9,7716860,11.66,Europe
2004,Athens,Greece,Cambodia,CAM,0,0,0,0,1,1,2,13066475,1.53,Asia
2004,Athens,Greece,Canada,CAN,28,19,25,72,89,53,142,31940655,44.46,North America
2004,Athens,Greece,Cape Verde,CPV,0,0,0,0,2,1,3,456619,65.7,Africa
2004,Athens,Greece,Central African Republic,CAF,0,0,0,0,1,0,1,3959883,2.53,Africa
2004,Athens,Greece,Chile,CHI,0,0,0,0,4,0,4,16014972,2.5,South America
2004,Athens,Greece,China,CHN,63,46,32,141,108,89,197,1296075000,1.52,Asia
1988,Seoul,Republic of Korea,Russia,URS,21,20,15,56,16,6,22,,,Europe
2004,Athens,Greece,Colombia,COL,0,0,0,0,4,1,5,42075953,1.19,South America
2004,Athens,Greece,Costa Rica,CRC,0,0,0,0,1,0,1,4225156,2.37,North America
1996,Atlanta,United States of America,Russia,RUS,9,7,11,27,60,10,70,,,Europe
2004,Athens,Greece,Croatia,CRO,0,0,4,4,12,5,17,4304600,39.49,Europe
2004,Athens,Greece,Cuba,CUB,2,2,7,11,19,5,24,11250369,21.33,North America
2004,Athens,Greece,Cyprus,CYP,1,0,0,1,2,3,5,1010410,49.48,Europe
2004,Athens,Greece,Czech Republic,CZE,16,8,7,31,45,20,65,10197101,63.74,Europe
2004,Athens,Greece,Denmark,DEN,5,3,7,15,22,10,32,5404523,59.21,Europe
2004,Athens,Greece,Dominican Republic,DOM,0,0,0,0,1,1,2,8974444,2.23,North America
2004,Athens,Greece,Ecuador,ECU,0,0,0,0,3,1,4,13596390,2.94,South America
2004,Athens,Greece,Egypt,EGY,6,9,8,23,36,10,46,74172073,6.2,Africa
2004,Athens,Greece,El Salvador,ESA,0,0,0,0,1,1,2,6023801,3.32,North America
2004,Athens,Greece,Estonia,EST,0,1,0,1,4,2,6,1362550,44.04,Europe
2004,Athens,Greece,Ethiopia,ETH,0,0,0,0,1,0,1,74239508,0.13,Africa
2004,Athens,Greece,Faroe Islands,FRO,0,0,1,1,0,1,1,47600,210.08,Europe
2004,Athens,Greece,Fiji,FIJ,0,0,0,0,1,1,2,817864,24.45,Oceania
2004,Athens,Greece,Finland,FIN,4,1,3,8,31,23,54,5228172,103.29,Europe
2004,Athens,Greece,France,FRA,18,26,30,74,102,30,132,62704901,21.05,Europe
2004,Athens,Greece,Germany,GER,19,28,31,78,138,70,208,82516260,25.21,Europe
2004,Athens,Greece,Ghana,GHA,0,0,0,0,2,1,3,21272328,1.41,Africa
2004,Athens,Greece,Great Britain,GBR,35,30,29,94,99,65,164,59987905,27.34,Europe
2004,Athens,Greece,Greece,GRE,3,13,4,20,104,17,121,10955141,110.45,Europe
2004,Athens,Greece,Guatemala,GUA,0,0,0,0,1,1,2,12682108,1.58,North America
2004,Athens,Greece,Guinea,GUY,0,0,0,0,1,0,1,8925729,1.12,Africa
2004,Athens,Greece,Honduras,HON,0,0,0,0,1,1,2,7282953,2.75,North America
2004,Athens,Greece,Hong Kong,HKG,11,7,1,19,15,9,24,6783500,35.38,Asia
2004,Athens,Greece,Hungary,HUN,1,8,10,19,25,12,37,10107146,36.61,Europe
2004,Athens,Greece,Iceland,ISL,1,3,0,4,2,1,3,292074,102.71,Europe
2004,Athens,Greece,India,IND,1,0,1,2,11,1,12,1129623466,0.11,Asia
2004,Athens,Greece,Indonesia,INA,0,0,0,0,3,0,3,223285666,0.13,Asia
2004,Athens,Greece,Islamic Republic of Iran,IRI,6,3,13,22,83,6,89,68951279,12.91,Asia
2004,Athens,Greece,Iraq,IRQ,1,0,1,2,8,0,8,26313838,3.04,Asia
2004,Athens,Greece,Ireland,IRL,0,3,1,4,32,8,40,4070262,98.27,Europe
2004,Athens,Greece,Israel,ISR,4,4,5,13,21,3,24,6809000,35.25,Asia
2004,Athens,Greece,Italy,ITA,4,8,7,19,61,14,75,57685327,13,Europe
2004,Athens,Greece,Jamaica,JAM,1,0,1,2,2,2,4,2725017,14.68,North America
2004,Athens,Greece,Japan,JPN,17,15,20,52,106,54,160,127761000,12.52,Asia
2004,Athens,Greece,Jordan,JOR,0,1,1,2,5,5,10,5580241,17.92,Asia
2004,Athens,Greece,Kazakhstan,KAZ,0,0,0,0,6,2,8,15012984,5.33,Europe
2004,Athens,Greece,Kenya,KEN,3,1,3,7,8,8,16,35635267,4.49,Africa
2004,Athens,Greece,Republic of Korea,KOR,11,11,6,28,70,10,80,48082519,16.64,Asia
2004,Athens,Greece,Kuwait,KUW,1,2,3,6,13,1,14,2200498,63.62,Asia
2004,Athens,Greece,Kyrgyzstan,KGZ,0,0,0,0,3,0,3,5104700,5.88,Asia
2004,Athens,Greece,Latvia,LAT,1,1,1,3,3,4,7,2263122,30.93,Europe
2004,Athens,Greece,Lesotho,LES,0,0,0,0,1,1,2,2005953,9.97,Africa
2004,Athens,Greece,Libya,LBA,0,0,0,0,1,1,2,5710163,3.5,Africa
2004,Athens,Greece,Liechtenstein,LIE,0,0,0,0,1,0,1,34444,290.33,Europe
2004,Athens,Greece,Lithuania,LTU,1,1,5,7,16,4,20,3377075,59.22,Europe
2000,Sydney,Australia,Russia,RUS,12,11,12,35,69,20,89,,,Europe
2004,Athens,Greece,Malaysia,MAS,0,0,0,0,15,4,19,25190647,7.54,Asia
2004,Athens,Greece,Mauritania,MTN,0,0,0,0,0,1,1,2939246,3.4,Africa
2004,Athens,Greece,Mauritius,MRI,0,0,0,0,1,1,2,1221003,16.38,Africa
2004,Athens,Greece,Mexico,MEX,14,10,10,34,36,41,77,104514934,7.37,North America
2004,Athens,Greece,Republic of Moldova,MDA,0,0,0,0,3,0,3,2895147,10.36,Europe
2004,Athens,Greece,Mongolia,MGL,0,0,0,0,2,1,3,2496394,12.02,Asia
2004,Athens,Greece,Morocco,MAR,2,4,0,6,7,3,10,30115196,3.32,Africa
2004,Athens,Greece,Namibia,NAM,0,0,0,0,1,0,1,1907737,5.24,Africa
2004,Athens,Greece,Nepal,NEP,0,0,0,0,0,1,1,25419337,0.39,Asia
2004,Athens,Greece,Netherlands,NED,5,12,12,29,51,42,93,16281779,57.12,Europe
2004,Athens,Greece,New Zealand,NZL,6,1,3,10,28,8,36,4087500,88.07,Oceania
2004,Athens,Greece,Nicaragua,NCA,0,0,0,0,1,0,1,5364930,1.86,North America
2004,Athens,Greece,Niger,NIG,0,0,0,0,1,0,1,13125914,0.76,Africa
2004,Athens,Greece,Nigeria,NGR,5,4,3,12,6,8,14,135320420,1.03,Africa
2004,Athens,Greece,North Macedonia,MKD,0,1,0,1,2,1,3,2057044,14.58,Europe
2004,Athens,Greece,Norway,NOR,3,1,1,5,19,11,30,4591910,65.33,Europe
2004,Athens,Greece,Oman,OMA,0,0,0,0,2,0,2,2445524,8.18,Asia
2004,Athens,Greece,Pakistan,PAK,0,0,0,0,8,1,9,156664698,0.57,Asia
2004,Athens,Greece,Russia,RUS,16,8,17,41,49,35,84,,,Europe
2004,Athens,Greece,Panama,PAN,0,1,0,1,1,1,2,3269356,6.12,North America
2004,Athens,Greece,Peru,PER,0,0,2,2,4,1,5,27624226,1.81,South America
2004,Athens,Greece,Philippines,PHI,0,0,0,0,1,1,2,84710544,0.24,Asia
2004,Athens,Greece,Poland,POL,10,25,19,54,68,34,102,38182222,26.71,Europe
2004,Athens,Greece,Portugal,POR,2,5,5,12,22,7,29,10483861,27.66,Europe
2004,Athens,Greece,Puerto Rico,PUR,0,0,1,1,1,1,2,3826878,5.23,North America
2004,Athens,Greece,Qatar,QAT,0,0,0,0,2,0,2,753332,26.55,Asia
2004,Athens,Greece,Romania,ROU,0,0,0,0,2,0,2,21451748,0.93,Europe
2008,Beijing,China,Russia,RUS,18,23,22,63,98,46,144,,,Europe
2004,Athens,Greece,Rwanda,RWA,0,0,1,1,1,1,2,8680516,2.3,Africa
2004,Athens,Greece,Samoa,SAM,0,0,0,0,1,1,2,178597,111.98,Oceania
2004,Athens,Greece,Saudi Arabia,KSA,0,0,0,0,6,0,6,23132686,2.59,Asia
2004,Athens,Greece,Senegal,SEN,0,0,0,0,1,1,2,10810086,1.85,Africa
2012,London,Great Britain,Russia,RUS,36,38,28,102,120,61,181,,,Europe
2004,Athens,Greece,Singapore,SGP,0,0,0,0,4,3,7,4166664,16.8,Asia
2004,Athens,Greece,Slovakia,SVK,5,3,4,12,28,8,36,5372280,67.01,Europe
2004,Athens,Greece,Slovenia,SLO,1,2,1,4,14,14,28,1997012,140.21,Europe
2004,Athens,Greece,South Africa,RSA,15,13,7,35,31,20,51,47291610,10.78,Africa
2004,Athens,Greece,Spain,ESP,20,27,24,71,118,34,152,42921895,35.41,Europe
2004,Athens,Greece,Sri Lanka,SRI,0,0,0,0,6,0,6,19387153,3.09,Asia
2004,Athens,Greece,Sudan,SUD,0,0,0,0,1,1,2,30214189,0.66,Africa
2004,Athens,Greece,Suriname,SUR,0,0,0,0,1,1,2,493680,40.51,South America
2004,Athens,Greece,Sweden,SWE,8,7,6,21,32,9,41,8993531,45.59,Europe
2004,Athens,Greece,Switzerland,SUI,2,6,8,16,26,14,40,7389625,54.13,Europe
2004,Athens,Greece,Syrian Arab Republic,SYR,0,0,0,0,3,2,5,17827827,2.8,Asia
2004,Athens,Greece,Tajikistan,TJK,0,0,0,0,1,0,1,6662391,1.5,Asia
1996,Atlanta,United States of America,Serbia and Montenegro,SCG,0,0,0,0,3,1,4,,,Europe
2004,Athens,Greece,Thailand,THA,3,6,6,15,33,10,43,64995303,6.62,Asia
2004,Athens,Greece,Tonga,TGA,0,0,0,0,0,1,1,100214,99.79,Oceania
2004,Athens,Greece,Tunisia,TUN,8,7,3,18,14,8,22,10022278,21.95,Africa
2004,Athens,Greece,Turkey,TUR,1,0,1,2,8,1,9,67010930,1.34,Europe
2004,Athens,Greece,Turkmenistan,TKM,0,0,0,0,4,0,4,4703396,8.5,Asia
2004,Athens,Greece,Uganda,UGA,0,0,0,0,1,1,2,26821300,0.75,Africa
2004,Athens,Greece,Ukraine,UKR,24,12,19,55,57,31,88,47451626,18.55,Europe
2004,Athens,Greece,United Arab Emirates,UAE,1,1,2,4,10,0,10,4068577,24.58,Asia
2004,Athens,Greece,United States of America,USA,27,22,39,88,147,87,234,292805298,7.99,North America
2004,Athens,Greece,Uruguay,URU,0,0,0,0,3,0,3,3321486,9.03,South America
2004,Athens,Greece,Uzbekistan,UZB,0,0,0,0,1,0,1,25864350,0.39,Asia
2004,Athens,Greece,Venezuela,VEN,0,1,2,3,14,2,16,25996594,6.15,South America
2004,Athens,Greece,Vietnam,VIE,0,0,0,0,0,4,4,83062819,0.48,Asia
2004,Athens,Greece,Zimbabwe,ZIM,1,0,0,1,1,1,2,12019911,1.66,Africa
2008,Beijing,China,Afghanistan,AFG,0,0,0,0,1,0,1,27722281,0.36,Asia
2008,Beijing,China,Algeria,ALG,4,3,8,15,21,7,28,34730604,8.06,Africa
2008,Beijing,China,Angola,ANG,0,3,0,3,5,1,6,21695636,2.77,Africa
2008,Beijing,China,Argentina,ARG,0,1,5,6,30,9,39,40080159,9.73,South America
2008,Beijing,China,Armenia,ARM,0,0,0,0,0,1,1,2907615,3.44,Europe
2008,Beijing,China,Australia,AUS,23,29,27,79,86,70,156,21249200,73.41,Oceania
2008,Beijing,China,Austria,AUT,4,1,1,6,34,4,38,8321496,45.66,Europe
2008,Beijing,China,Azerbaijan,AZE,2,3,5,10,17,1,18,8763400,20.54,Europe
2008,Beijing,China,Bahrain,BRN,0,0,0,0,2,1,3,1114645,26.91,Asia
2008,Beijing,China,Bangladesh,BAN,0,0,0,0,1,0,1,144304164,0.07,Asia
2008,Beijing,China,Barbados,BAR,0,0,0,0,1,0,1,279946,35.72,North America
2008,Beijing,China,Belarus,BLR,5,7,1,13,19,11,30,9527985,31.49,Europe
2008,Beijing,China,Belgium,BEL,0,0,1,1,19,1,20,10709973,18.67,Europe
2008,Beijing,China,Benin,BEN,0,0,0,0,0,1,1,8696915,1.15,Africa
2008,Beijing,China,Bermuda,BER,0,0,0,0,1,0,1,65273,153.2,North America
2008,Beijing,China,Bosnia and Herzegovina,BIH,0,1,0,1,14,1,15,3754261,39.95,Europe
2008,Beijing,China,Brazil,BRA,16,14,17,47,130,54,184,192030362,9.58,South America
2008,Beijing,China,Bulgaria,BUL,0,1,1,2,4,4,8,7492561,10.68,Europe
2008,Beijing,China,Burkina Faso,BUR,0,0,0,0,1,0,1,14689725,0.68,Africa
2008,Beijing,China,Burundi,BDI,0,0,0,0,3,0,3,8126104,3.69,Africa
2008,Beijing,China,Cambodia,CAM,0,0,0,0,1,0,1,13883835,0.72,Asia
2008,Beijing,China,Canada,CAN,19,10,21,50,80,61,141,33247118,42.41,North America
2008,Beijing,China,Cape Verde,CPV,0,0,0,0,0,1,1,480846,20.8,Africa
2008,Beijing,China,Central African Republic,CAF,0,0,0,0,1,0,1,4273368,2.34,Africa
2008,Beijing,China,Chile,CHI,0,0,0,0,3,1,4,16708255,2.39,South America
2008,Beijing,China,China,CHN,89,70,52,211,196,135,331,1324655000,2.5,Asia
2000,Sydney,Australia,Serbia and Montenegro,SCG,0,0,0,0,3,1,4,,,Europe
2008,Beijing,China,Colombia,COL,0,1,1,2,9,2,11,44254972,2.49,South America
2008,Beijing,China,Costa Rica,CRC,0,0,0,0,2,0,2,4463123,4.48,North America
2004,Athens,Greece,Serbia and Montenegro,SCG,0,0,2,2,5,0,5,,,Europe
2008,Beijing,China,Croatia,CRO,3,1,0,4,19,6,25,4309705,58.01,Europe
2008,Beijing,China,Cuba,CUB,5,3,6,14,26,5,31,11236975,27.59,North America
2008,Beijing,China,Cyprus,CYP,1,2,1,4,3,1,4,1081568,36.98,Europe
2008,Beijing,China,Czech Republic,CZE,6,3,18,27,37,19,56,10384603,53.93,Europe
2008,Beijing,China,Denmark,DEN,3,2,4,9,22,15,37,5493621,67.35,Europe
2008,Beijing,China,Dominican Republic,DOM,0,0,0,0,1,0,1,9458079,1.06,North America
2008,Beijing,China,Ecuador,ECU,0,0,0,0,1,1,2,14535740,1.38,South America
2008,Beijing,China,Egypt,EGY,4,4,4,12,27,9,36,79636081,4.52,Africa
2008,Beijing,China,El Salvador,ESA,0,0,0,0,0,1,1,6131767,1.63,North America
2008,Beijing,China,Estonia,EST,0,0,1,1,3,0,3,1337090,22.44,Europe
2008,Beijing,China,Ethiopia,ETH,0,0,0,0,2,0,2,82916236,0.24,Africa
2008,Beijing,China,Faroe Islands,FRO,0,0,0,0,0,1,1,47822,209.11,Europe
2008,Beijing,China,Fiji,FIJ,0,0,0,0,1,0,1,845356,11.83,Oceania
2008,Beijing,China,Finland,FIN,2,2,2,6,25,6,31,5313399,58.34,Europe
2008,Beijing,China,France,FRA,12,21,19,52,80,39,119,64374979,18.49,Europe
2008,Beijing,China,Gabon,GAB,0,0,0,0,1,0,1,1518538,6.59,Africa
2008,Beijing,China,Georgia,GEO,0,0,0,0,1,0,1,3848449,2.6,Europe
2008,Beijing,China,Germany,GER,14,25,20,59,104,66,170,82110097,20.7,Europe
2008,Beijing,China,Ghana,GHA,0,0,0,0,1,1,2,23563832,0.85,Africa
2008,Beijing,China,Great Britain,GBR,42,29,31,102,130,75,205,61806995,33.17,Europe
2008,Beijing,China,Greece,GRE,5,9,10,24,52,15,67,11077841,60.48,Europe
2008,Beijing,China,Guatemala,GUA,0,0,0,0,1,0,1,13739299,0.73,North America
2008,Beijing,China,Guinea,GUY,0,0,0,0,1,0,1,9738796,1.03,Africa
2008,Beijing,China,Haiti,HAI,0,0,0,0,0,1,1,9646570,1.04,North America
2008,Beijing,China,Honduras,HON,0,0,0,0,1,0,1,7980955,1.25,North America
2008,Beijing,China,Hong Kong,HKG,5,3,3,11,10,12,22,6957800,31.62,Asia
2008,Beijing,China,Hungary,HUN,1,0,5,6,23,10,33,10038188,32.87,Europe
2008,Beijing,China,Iceland,ISL,0,0,0,0,4,1,5,317414,157.52,Europe
2008,Beijing,China,India,IND,0,0,0,0,5,0,5,1200669762,0.04,Asia
2008,Beijing,China,Indonesia,INA,0,0,0,0,2,1,3,235469755,0.13,Asia
2008,Beijing,China,Islamic Republic of Iran,IRI,5,6,3,14,68,4,72,72120608,9.98,Asia
2008,Beijing,China,Iraq,IRQ,0,1,1,2,17,2,19,28385739,6.69,Asia
2008,Beijing,China,Ireland,IRL,3,1,1,5,33,12,45,4489544,100.23,Europe
2008,Beijing,China,Israel,ISR,0,5,1,6,34,8,42,7308800,57.46,Asia
2008,Beijing,China,Italy,ITA,4,7,7,18,55,27,82,58826731,13.94,Europe
2008,Beijing,China,Jamaica,JAM,0,0,1,1,2,2,4,2781869,14.38,North America
2008,Beijing,China,Japan,JPN,5,14,8,27,97,64,161,128063000,12.57,Asia
2008,Beijing,China,Jordan,JOR,0,2,2,4,7,5,12,6556473,18.3,Asia
2008,Beijing,China,Kazakhstan,KAZ,0,0,0,0,1,2,3,15776938,1.9,Europe
2008,Beijing,China,Kenya,KEN,5,3,1,9,10,3,13,39791984,3.27,Africa
2008,Beijing,China,Republic of Korea,KOR,10,8,13,31,57,20,77,49054708,15.7,Asia
2008,Beijing,China,Kuwait,KUW,0,0,0,0,7,1,8,2656010,30.12,Asia
2008,Beijing,China,Kyrgyzstan,KGZ,0,0,0,0,1,0,1,5318700,1.88,Asia
2008,Beijing,China,Lao People's Democratic Republic,LAO,0,0,1,1,1,0,1,6046630,1.65,Asia
2008,Beijing,China,Latvia,LAT,1,2,0,3,4,13,17,2177322,78.08,Europe
2008,Beijing,China,Lebanon,LBN,0,0,2,2,1,0,1,4764745,2.1,Asia
2008,Beijing,China,Lesotho,LES,0,0,0,0,0,1,1,1987130,5.03,Africa
2008,Beijing,China,Libya,LBA,0,0,0,0,2,1,3,6058740,4.95,Africa
2008,Beijing,China,Lithuania,LTU,0,2,0,2,12,14,26,3198231,81.29,Europe
2008,Beijing,China,Luxembourg,LUX,0,0,0,0,1,0,1,488650,20.46,Europe
1992,Barcelona,Spain,Taipei,TPE,0,0,1,1,10,1,11,,,Asia
2008,Beijing,China,Madagascar,MAD,0,0,0,0,1,0,1,19996476,0.5,Africa
2008,Beijing,China,Malaysia,MAS,0,0,1,1,8,3,11,27236003,4.04,Asia
2008,Beijing,China,Malta,MLT,0,0,0,0,1,0,1,409379,24.43,Europe
2008,Beijing,China,Mauritius,MRI,0,0,0,0,2,0,2,1244121,16.08,Africa
2008,Beijing,China,Mexico,MEX,10,3,7,20,30,37,67,110815272,6.05,North America
2008,Beijing,China,Republic of Moldova,MDA,0,0,0,0,0,1,1,2867964,3.49,Europe
2008,Beijing,China,Mongolia,MGL,1,0,0,1,1,3,4,2631899,15.2,Asia
2008,Beijing,China,Montenegro,MNE,0,0,0,0,1,0,1,616969,16.21,Europe
2008,Beijing,China,Morocco,MAR,4,1,2,7,12,6,18,31536807,5.71,Africa
2008,Beijing,China,Myanmar,MYA,0,0,0,0,3,0,3,49929642,0.6,Asia
2008,Beijing,China,Namibia,NAM,0,0,1,1,1,0,1,2043382,4.89,Africa
2008,Beijing,China,Nepal,NEP,0,0,0,0,1,0,1,26666581,0.38,Asia
2008,Beijing,China,Netherlands,NED,5,10,7,22,33,46,79,16445593,48.04,Europe
2008,Beijing,China,New Zealand,NZL,5,3,4,12,20,9,29,4259800,68.08,Oceania
2008,Beijing,China,Niger,NIG,0,0,0,0,1,0,1,15250913,0.66,Africa
2008,Beijing,China,Nigeria,NGR,4,4,1,9,14,9,23,150269622,1.53,Africa
2008,Beijing,China,North Macedonia,MKD,0,0,0,0,1,1,2,2067309,9.67,Europe
2008,Beijing,China,Norway,NOR,1,3,3,7,14,10,24,4768212,50.33,Europe
2008,Beijing,China,Oman,OMA,0,0,0,0,1,0,1,2750956,3.64,Asia
2008,Beijing,China,Pakistan,PAK,0,1,0,1,2,1,3,171648984,0.17,Asia
1996,Atlanta,United States of America,Taipei,TPE,1,0,2,3,13,1,14,,,Asia
2008,Beijing,China,Panama,PAN,0,0,0,0,1,1,2,3516204,5.69,North America
2008,Beijing,China,Papua New Guinea,PNG,0,1,0,1,1,1,2,6976200,2.87,Oceania
2008,Beijing,China,Peru,PER,0,0,0,0,3,0,3,28562321,1.05,South America
2008,Beijing,China,Philippines,PHI,0,0,0,0,1,2,3,90901967,0.33,Asia
2008,Beijing,China,Poland,POL,5,12,13,30,58,33,91,38125759,23.87,Europe
2008,Beijing,China,Portugal,POR,1,4,2,7,23,12,35,10558177,33.15,Europe
2008,Beijing,China,Puerto Rico,PUR,0,0,1,1,2,1,3,3760866,7.98,North America
2008,Beijing,China,Qatar,QAT,0,0,0,0,2,0,2,1436670,13.92,Asia
2008,Beijing,China,Romania,ROU,0,1,0,1,2,2,4,20537875,1.95,Europe
2000,Sydney,Australia,Taipei,TPE,1,2,4,7,17,8,25,,,Asia
2008,Beijing,China,Rwanda,RWA,0,0,0,0,1,0,1,9524532,1.05,Africa
2008,Beijing,China,Samoa,SAM,0,0,0,0,1,0,1,183270,54.56,Oceania
2008,Beijing,China,Saudi Arabia,KSA,1,1,0,2,3,0,3,25888535,1.16,Asia
2008,Beijing,China,Senegal,SEN,0,0,0,0,1,1,2,12004700,1.67,Africa
2008,Beijing,China,Serbia,SRB,0,2,0,2,10,4,14,7350222,19.05,Europe
2008,Beijing,China,Singapore,SGP,1,1,2,4,2,4,6,4839396,12.4,Asia
2008,Beijing,China,Slovakia,SVK,2,3,1,6,26,9,35,5379233,65.07,Europe
2008,Beijing,China,Slovenia,SLO,0,1,2,3,14,16,30,2021316,148.42,Europe
2008,Beijing,China,South Africa,RSA,21,3,6,30,38,21,59,49779472,11.85,Africa
2008,Beijing,China,Spain,ESP,15,21,22,58,101,32,133,45954106,28.94,Europe
2008,Beijing,China,Sri Lanka,SRI,0,0,0,0,5,0,5,19983984,2.5,Asia
2008,Beijing,China,Suriname,SUR,0,0,0,0,1,0,1,517122,19.34,South America
2008,Beijing,China,Sweden,SWE,5,3,4,12,38,25,63,9219637,68.33,Europe
2008,Beijing,China,Switzerland,SUI,3,2,6,11,18,8,26,7647675,34,Europe
2008,Beijing,China,Syrian Arab Republic,SYR,0,0,1,1,3,2,5,20664037,2.42,Asia
2008,Beijing,China,Tajikistan,TJK,0,0,0,0,0,1,1,7209924,1.39,Asia
2004,Athens,Greece,Taipei,TPE,2,2,2,6,15,10,25,,,Asia
2008,Beijing,China,Thailand,THA,1,5,7,13,33,7,40,66530980,6.01,Asia
2008,Beijing,China,Timor-Leste,TLS,0,0,0,0,0,1,1,1055428,9.47,Asia
2008,Beijing,China,Tonga,TGA,0,0,0,0,1,0,1,103384,96.73,Oceania
2008,Beijing,China,Tunisia,TUN,9,9,3,21,21,12,33,10414425,31.69,Africa
2008,Beijing,China,Turkey,TUR,1,0,1,2,8,8,16,70418612,2.27,Europe
2008,Beijing,China,Turkmenistan,TKM,0,0,0,0,1,2,3,4935765,6.08,Asia
2008,Beijing,China,Uganda,UGA,0,0,0,0,1,0,1,30431734,0.33,Africa
2008,Beijing,China,Ukraine,UKR,24,18,32,74,74,49,123,46258189,26.59,Europe
2008,Beijing,China,United Arab Emirates,UAE,0,1,0,1,6,1,7,7089486,9.87,Asia
2008,Beijing,China,United States of America,USA,36,35,28,99,120,87,207,304093966,6.81,North America
2008,Beijing,China,Uruguay,URU,0,0,0,0,2,0,2,3340221,5.99,South America
2008,Beijing,China,Uzbekistan,UZB,0,0,0,0,2,0,2,27302800,0.73,Asia
2008,Beijing,China,Vanuatu,VAN,0,0,0,0,1,0,1,224700,44.5,Oceania
2008,Beijing,China,Venezuela,VEN,1,1,2,4,19,8,27,27635827,9.77,South America
2008,Beijing,China,Vietnam,VIE,0,0,0,0,3,5,8,86243424,0.93,Asia
2008,Beijing,China,Zambia,ZAM,0,0,0,0,1,0,1,12848531,0.78,Africa
2008,Beijing,China,Zimbabwe,ZIM,0,0,0,0,1,1,2,12379553,1.62,Africa
2012,London,Great Britain,Afghanistan,AFG,0,0,0,0,1,0,1,31161378,0.32,Asia
2012,London,Great Britain,Albania,ALB,0,0,0,0,1,0,1,2900401,3.45,Europe
2012,London,Great Britain,Algeria,ALG,4,6,9,19,24,7,31,37383899,8.29,Africa
2012,London,Great Britain,Andorra,AND,0,0,0,0,1,0,1,82427,121.32,Europe
2012,London,Great Britain,Angola,ANG,1,0,1,2,2,2,4,25107925,1.59,Africa
2012,London,Great Britain,Antigua and Barbuda,ANT,0,0,0,0,1,0,1,90407,110.61,North America
2012,London,Great Britain,Argentina,ARG,0,1,4,5,47,10,57,41733271,13.66,South America
2012,London,Great Britain,Armenia,ARM,0,0,0,0,0,2,2,2884239,6.93,Europe
2012,London,Great Britain,Australia,AUS,32,23,30,85,88,70,158,22733465,69.5,Oceania
2012,London,Great Britain,Austria,AUT,4,3,6,13,27,5,32,8429991,37.96,Europe
2012,London,Great Britain,Azerbaijan,AZE,4,5,3,12,16,5,21,9295784,22.59,Europe
2012,London,Great Britain,Bahrain,BRN,0,0,0,0,1,1,2,1299942,15.39,Asia
2012,London,Great Britain,Barbados,BAR,0,0,0,0,1,0,1,283698,35.25,North America
2012,London,Great Britain,Belarus,BLR,5,2,3,10,15,14,29,9464495,30.64,Europe
2012,London,Great Britain,Belgium,BEL,3,1,3,7,31,9,40,11106932,36.01,Europe
2012,London,Great Britain,Benin,BEN,0,0,0,0,1,0,1,9729254,1.03,Africa
2012,London,Great Britain,Bermuda,BER,0,0,0,0,0,1,1,64798,154.33,North America
2012,London,Great Britain,Bosnia and Herzegovina,BIH,1,0,0,1,11,1,12,3604972,33.29,Europe
2012,London,Great Britain,Brazil,BRA,21,14,8,43,110,68,178,199287292,8.93,South America
2012,London,Great Britain,Brunei Darussalam,BRU,0,0,0,0,1,0,1,398997,25.06,Asia
2012,London,Great Britain,Bulgaria,BUL,0,2,1,3,4,4,8,7305888,10.95,Europe
2012,London,Great Britain,Burkina Faso,BUR,0,0,0,0,1,1,2,16571252,1.21,Africa
2012,London,Great Britain,Burundi,BDI,0,0,0,0,1,0,1,9245992,1.08,Africa
2012,London,Great Britain,Cambodia,CAM,0,0,0,0,0,1,1,14780454,0.68,Asia
2012,London,Great Britain,Cameroon,CMR,0,0,0,0,1,0,1,21485267,0.47,Africa
2012,London,Great Britain,Canada,CAN,7,15,9,31,87,57,144,34714222,41.48,North America
2012,London,Great Britain,Cape Verde,CPV,0,0,0,0,1,0,1,505241,19.79,Africa
2012,London,Great Britain,Central African Republic,CAF,0,0,0,0,1,0,1,4436411,2.25,Africa
2012,London,Great Britain,Chile,CHI,1,0,0,1,4,3,7,17400359,4.02,South America
2012,London,Great Britain,China,CHN,95,71,65,231,154,128,282,1350695000,2.09,Asia
2008,Beijing,China,Taipei,TPE,1,0,1,2,10,7,17,,,Asia
2012,London,Great Britain,Colombia,COL,0,2,0,2,30,7,37,46075721,8.03,South America
2012,London,Great Britain,Comoros,COM,0,0,0,0,1,0,1,723865,13.81,Africa
2012,London,Great Britain,Costa Rica,CRC,0,0,0,0,2,0,2,4688003,4.27,North America
2012,London,Great Britain,Taipei,TPE,0,1,2,3,9,9,18,,,Asia
2012,London,Great Britain,Croatia,CRO,0,2,3,5,18,7,25,4267558,58.58,Europe
2012,London,Great Britain,Cuba,CUB,9,5,3,17,18,4,22,11257112,19.54,North America
2012,London,Great Britain,Cyprus,CYP,0,1,0,1,2,1,3,1135046,26.43,Europe
2012,London,Great Britain,Czech Republic,CZE,1,6,4,11,31,15,46,10510785,43.76,Europe
2012,London,Great Britain,Denmark,DEN,1,0,4,5,15,13,28,5591572,50.08,Europe
2012,London,Great Britain,Djibouti,DJI,0,0,0,0,1,0,1,868136,11.52,Africa
2012,London,Great Britain,Dominican Republic,DOM,0,0,0,0,2,0,2,9930916,2.01,North America
2016,Rio de Janeiro,Brazil,Taipei,TPE,0,1,1,2,5,8,13,,,Asia
2012,London,Great Britain,Ecuador,ECU,0,0,0,0,1,1,2,15474099,1.29,South America
2012,London,Great Britain,Egypt,EGY,4,4,7,15,29,11,40,86422240,4.63,Africa
2012,London,Great Britain,El Salvador,ESA,0,0,0,0,1,0,1,6237922,1.6,North America
2012,London,Great Britain,Estonia,EST,0,0,0,0,2,1,3,1322696,22.68,Europe
2012,London,Great Britain,Ethiopia,ETH,0,1,0,1,3,1,4,92726982,0.43,Africa
2012,London,Great Britain,Faroe Islands,FRO,0,0,0,0,1,0,1,47843,209.02,Europe
2012,London,Great Britain,Fiji,FIJ,1,0,0,1,1,0,1,865065,11.56,Oceania
2012,London,Great Britain,Finland,FIN,4,1,1,6,21,14,35,5413971,64.65,Europe
2012,London,Great Britain,France,FRA,8,19,18,45,101,51,152,65659814,23.15,Europe
2012,London,Great Britain,Gabon,GAB,0,0,0,0,1,0,1,1749677,5.72,Africa
2012,London,Great Britain,Gambia,GAM,0,0,0,0,1,1,2,1905020,10.5,Africa
2012,London,Great Britain,Georgia,GEO,0,0,0,0,2,0,2,3728874,5.36,Europe
2012,London,Great Britain,Germany,GER,18,26,22,66,88,62,150,80425823,18.65,Europe
2012,London,Great Britain,Ghana,GHA,0,0,0,0,3,1,4,25996454,1.54,Africa
2012,London,Great Britain,Great Britain,GBR,34,43,43,120,177,109,286,63700215,44.9,Europe
2012,London,Great Britain,Greece,GRE,1,3,8,12,47,13,60,11045011,54.32,Europe
2012,London,Great Britain,Guatemala,GUA,0,0,0,0,1,0,1,14781942,0.68,North America
2012,London,Great Britain,Guinea-Bissau,GBS,0,0,0,0,1,1,2,1604981,12.46,Africa
2012,London,Great Britain,Haiti,HAI,0,0,0,0,2,1,3,10250922,2.93,North America
2012,London,Great Britain,Honduras,HON,0,0,0,0,1,0,1,8640692,1.16,North America
2012,London,Great Britain,Hong Kong,HKG,3,3,6,12,13,15,28,7150100,39.16,Asia
2012,London,Great Britain,Hungary,HUN,2,6,6,14,19,14,33,9920362,33.26,Europe
2012,London,Great Britain,Iceland,ISL,1,0,0,1,2,2,4,320716,124.72,Europe
2012,London,Great Britain,India,IND,0,1,0,1,10,0,10,1265780243,0.08,Asia
2012,London,Great Britain,Indonesia,INA,0,0,1,1,3,1,4,248451714,0.16,Asia
2012,London,Great Britain,Islamic Republic of Iran,IRI,10,7,7,24,70,7,77,75539881,10.19,Asia
2012,London,Great Britain,Iraq,IRQ,0,2,1,3,16,3,19,31890012,5.96,Asia
2012,London,Great Britain,Ireland,IRL,8,3,5,16,28,17,45,4599533,97.84,Europe
2012,London,Great Britain,Israel,ISR,1,2,5,8,18,7,25,7910500,31.6,Asia
2012,London,Great Britain,Italy,ITA,9,8,11,28,65,31,96,59539717,16.12,Europe
2012,London,Great Britain,Jamaica,JAM,1,0,0,1,2,1,3,2842128,10.56,North America
2012,London,Great Britain,Japan,JPN,5,5,6,16,89,45,134,127629000,10.5,Asia
2012,London,Great Britain,Jordan,JOR,0,0,0,0,4,4,8,8089963,9.89,Asia
2012,London,Great Britain,Kazakhstan,KAZ,0,0,0,0,4,3,7,16792090,4.17,Europe
2012,London,Great Britain,Kenya,KEN,2,2,2,6,10,2,12,44343469,2.71,Africa
2012,London,Great Britain,Republic of Korea,KOR,9,9,9,27,60,28,88,50199853,17.53,Asia
2020,Tokyo,Japan,Taipei,TPE,0,0,1,1,4,6,10,,,Asia
2012,London,Great Britain,Kuwait,KUW,0,0,0,0,6,0,6,3348852,17.92,Asia
2012,London,Great Britain,Kyrgyzstan,KGZ,0,0,0,0,1,0,1,5607200,1.78,Asia
2012,London,Great Britain,Lao People's Democratic Republic,LAO,0,0,0,0,1,0,1,6444527,1.55,Asia
2012,London,Great Britain,Latvia,LAT,1,1,0,2,6,2,8,2034319,39.33,Europe
2012,London,Great Britain,Lebanon,LBN,0,0,0,0,1,0,1,5537620,1.81,Asia
2012,London,Great Britain,Lesotho,LES,0,0,0,0,0,1,1,2014988,4.96,Africa
2012,London,Great Britain,Liberia,LBR,0,0,0,0,1,0,1,4135662,2.42,Africa
2012,London,Great Britain,Libya,LBA,0,0,0,0,2,0,2,6285751,3.18,Africa
2012,London,Great Britain,Lithuania,LTU,0,0,0,0,9,2,11,2987773,36.82,Europe
1992,Barcelona,Spain,Tanzania,TAN,0,0,0,0,1,0,1,26961204,0.00,Africa
2012,London,Great Britain,Madagascar,MAD,0,0,0,0,1,0,1,22346641,0.45,Africa
2012,London,Great Britain,Malaysia,MAS,0,1,1,2,16,6,22,29068189,7.57,Asia
2012,London,Great Britain,Mali,MLI,0,0,0,0,1,0,1,15979492,0.63,Africa
2012,London,Great Britain,Malta,MLT,0,0,0,0,1,0,1,420028,23.81,Europe
2012,London,Great Britain,Mauritania,MTN,0,0,0,0,1,1,2,3706555,5.4,Africa
2012,London,Great Britain,Mauritius,MRI,0,0,0,0,1,1,2,1255882,15.93,Africa
2012,London,Great Britain,Mexico,MEX,6,4,11,21,37,44,81,117274156,6.91,North America
2012,London,Great Britain,Republic of Moldova,MDA,0,0,0,0,1,1,2,2859458,6.99,Europe
2012,London,Great Britain,Mongolia,MGL,0,0,0,0,3,3,6,2824698,21.24,Asia
2012,London,Great Britain,Montenegro,MNE,0,0,0,0,0,1,1,620601,16.11,Europe
2012,London,Great Britain,Morocco,MAR,3,0,3,6,24,6,30,33241898,9.02,Africa
2012,London,Great Britain,Mozambique,MOZ,0,0,0,0,1,1,2,24862673,0.8,Africa
2012,London,Great Britain,Myanmar,MYA,0,0,0,0,2,0,2,51413703,0.39,Asia
2012,London,Great Britain,Namibia,NAM,1,1,0,2,4,1,5,2194777,22.78,Africa
2012,London,Great Britain,Nepal,NEP,0,0,0,0,1,1,2,26989160,0.74,Asia
2012,London,Great Britain,Netherlands,NED,10,10,19,39,39,49,88,16754962,52.52,Europe
2012,London,Great Britain,New Zealand,NZL,6,7,4,17,11,12,23,4408100,52.18,Oceania
2012,London,Great Britain,Nicaragua,NCA,0,0,0,0,1,1,2,5982530,3.34,North America
2012,London,Great Britain,Niger,NIG,0,0,0,0,1,1,2,17795209,1.12,Africa
2012,London,Great Britain,Nigeria,NGR,6,5,2,13,17,12,29,167228803,1.73,Africa
2012,London,Great Britain,North Macedonia,MKD,1,0,0,1,1,1,2,2074275,9.64,Europe
2012,London,Great Britain,Norway,NOR,3,2,3,8,13,9,22,5018573,43.84,Europe
2012,London,Great Britain,Oman,OMA,0,0,0,0,2,0,2,3498031,5.72,Asia
2012,London,Great Britain,Pakistan,PAK,0,0,0,0,2,0,2,187280125,0.11,Asia
2004,Athens,Greece,Tanzania,TAN,0,0,0,0,1,1,2,37379766,0.00,Africa
2012,London,Great Britain,Panama,PAN,0,0,0,0,1,1,2,3770635,5.3,North America
2012,London,Great Britain,Papua New Guinea,PNG,0,0,0,0,2,0,2,7631003,2.62,Oceania
2012,London,Great Britain,Peru,PER,0,0,0,0,1,0,1,29506790,0.34,South America
2012,London,Great Britain,Philippines,PHI,0,0,0,0,4,5,9,97212639,0.93,Asia
2012,London,Great Britain,Poland,POL,14,13,9,36,64,35,99,38063164,26.01,Europe
2012,London,Great Britain,Portugal,POR,0,1,2,3,22,8,30,10514844,28.53,Europe
2012,London,Great Britain,Puerto Rico,PUR,0,0,0,0,2,0,2,3634488,5.5,North America
2012,London,Great Britain,Qatar,QAT,0,0,0,0,1,0,1,2196078,4.55,Asia
2012,London,Great Britain,Romania,ROU,1,1,0,2,4,1,5,20058035,2.49,Europe
2008,Beijing,China,Tanzania,TAN,0,0,0,0,1,0,1,41853944,0.00,Africa
2012,London,Great Britain,Rwanda,RWA,0,0,0,0,14,0,14,10549668,13.27,Africa
2012,London,Great Britain,Samoa,SAM,0,0,0,0,1,1,2,189089,105.77,Oceania
2012,London,Great Britain,San Marino,SMR,0,0,0,0,1,0,1,32103,311.5,Europe
2012,London,Great Britain,Saudi Arabia,KSA,0,1,0,1,4,0,4,29154906,1.37,Asia
2012,London,Great Britain,Senegal,SEN,0,0,0,0,1,0,1,13401990,0.75,Africa
2012,London,Great Britain,Serbia,SRB,2,3,0,5,9,4,13,7199077,18.06,Europe
2012,London,Great Britain,Sierra Leone,SLE,0,0,0,0,1,0,1,6712586,1.49,Africa
2012,London,Great Britain,Singapore,SGP,0,1,1,2,2,6,8,5312437,15.06,Asia
2012,London,Great Britain,Slovakia,SVK,2,1,3,6,25,8,33,5407579,61.03,Europe
2012,London,Great Britain,Slovenia,SLO,0,1,0,1,7,15,22,2057159,106.94,Europe
2012,London,Great Britain,Solomon Islands,SOL,0,0,0,0,0,1,1,556066,17.98,Oceania
2012,London,Great Britain,South Africa,RSA,8,12,9,29,44,18,62,52832659,11.74,Africa
2012,London,Great Britain,Spain,ESP,8,18,16,42,98,29,127,46773055,27.15,Europe
2012,London,Great Britain,Sri Lanka,SRI,0,0,1,1,6,1,7,20425000,3.43,Asia
2012,London,Great Britain,Suriname,SUR,0,0,0,0,1,0,1,541247,18.48,South America
2012,London,Great Britain,Sweden,SWE,4,4,4,12,40,19,59,9519374,61.98,Europe
2012,London,Great Britain,Switzerland,SUI,3,6,4,13,15,10,25,7996861,31.26,Europe
2012,London,Great Britain,Syrian Arab Republic,SYR,0,0,0,0,3,2,5,20438861,2.45,Asia
2012,London,Great Britain,Tajikistan,TJK,0,0,0,0,1,0,1,7874838,1.27,Asia
2012,London,Great Britain,Tanzania,TAN,0,0,0,0,1,0,1,47053033,0.00,Africa
2012,London,Great Britain,Thailand,THA,4,2,2,8,38,11,49,67835969,7.22,Asia
2012,London,Great Britain,Timor-Leste,TLS,0,0,0,0,1,0,1,1133002,8.83,Asia
2012,London,Great Britain,Tonga,TGA,0,0,0,0,1,0,1,102736,97.34,Oceania
2012,London,Great Britain,Trinidad and Tobago,TTO,0,0,0,0,1,1,2,1344814,14.87,North America
2012,London,Great Britain,Tunisia,TUN,9,5,5,19,18,13,31,10846993,28.58,Africa
2012,London,Great Britain,Turkey,TUR,1,5,4,10,46,21,67,74651046,8.98,Europe
2012,London,Great Britain,Turkmenistan,TKM,0,0,0,0,3,2,5,5267906,9.49,Asia
2012,London,Great Britain,US Virgin Islands,ISV,0,0,0,0,0,1,1,108188,92.43,North America
2012,London,Great Britain,Uganda,UGA,0,0,0,0,1,1,2,34558700,0.58,Africa
2012,London,Great Britain,Ukraine,UKR,32,24,28,84,83,65,148,45593342,32.46,Europe
2012,London,Great Britain,United Arab Emirates,UAE,1,1,1,3,11,4,15,9141598,16.41,Asia
2012,London,Great Britain,United States of America,USA,31,29,38,98,128,93,221,313877662,7.04,North America
2012,London,Great Britain,Uruguay,URU,0,0,0,0,1,0,1,3378975,2.96,South America
2012,London,Great Britain,Uzbekistan,UZB,0,1,0,1,8,2,10,29774500,3.36,Asia
2012,London,Great Britain,Vanuatu,VAN,0,0,0,0,1,0,1,249505,40.08,Oceania
2012,London,Great Britain,Venezuela,VEN,0,0,2,2,21,6,27,29360827,9.2,South America
2012,London,Great Britain,Vietnam,VIE,0,0,0,0,6,5,11,89801926,1.22,Asia
2012,London,Great Britain,Zambia,ZAM,0,0,0,0,1,1,2,14465148,1.38,Africa
2012,London,Great Britain,Zimbabwe,ZIM,0,0,0,0,2,0,2,13115149,1.52,Africa
2016,Rio de Janeiro,Brazil,Afghanistan,AFG,0,0,0,0,1,0,1,35383028,0.28,Asia
2016,Rio de Janeiro,Brazil,Algeria,ALG,4,5,7,16,34,26,60,40551398,14.8,Africa
2016,Rio de Janeiro,Brazil,Angola,ANG,0,0,0,0,2,2,4,28842482,1.39,Africa
2016,Rio de Janeiro,Brazil,Argentina,ARG,1,1,3,5,56,26,82,43590368,18.81,South America
2016,Rio de Janeiro,Brazil,Armenia,ARM,0,0,0,0,0,2,2,2936147,6.81,Europe
2016,Rio de Janeiro,Brazil,Aruba,ARU,0,0,0,0,1,0,1,104865,95.36,North America
2016,Rio de Janeiro,Brazil,Australia,AUS,22,30,29,81,101,69,170,24190907,70.27,Oceania
2016,Rio de Janeiro,Brazil,Austria,AUT,1,4,4,9,21,6,27,8736668,30.9,Europe
2016,Rio de Janeiro,Brazil,Azerbaijan,AZE,1,8,2,11,18,5,23,9757812,23.57,Europe
2016,Rio de Janeiro,Brazil,Bahrain,BRN,1,0,0,1,0,2,2,1425793,14.03,Asia
2016,Rio de Janeiro,Brazil,Belarus,BLR,8,0,2,10,10,10,20,9501534,21.05,Europe
2016,Rio de Janeiro,Brazil,Belgium,BEL,5,3,3,11,19,10,29,11331422,25.59,Europe
2016,Rio de Janeiro,Brazil,Benin,BEN,0,0,0,0,1,0,1,10872072,0.92,Africa
2016,Rio de Janeiro,Brazil,Bermuda,BER,0,0,0,0,0,2,2,64554,309.82,North America
2016,Rio de Janeiro,Brazil,Bosnia and Herzegovina,BIH,0,1,0,1,13,1,14,3386263,41.34,Europe
2016,Rio de Janeiro,Brazil,Botswana,BOT,0,0,0,0,1,0,1,2159925,4.63,Africa
2016,Rio de Janeiro,Brazil,Brazil,BRA,14,29,29,72,184,102,286,206163056,13.87,South America
2016,Rio de Janeiro,Brazil,Bulgaria,BUL,1,0,0,1,4,3,7,7127822,9.82,Europe
2016,Rio de Janeiro,Brazil,Burkina Faso,BUR,0,0,0,0,1,0,1,18646350,0.54,Africa
2016,Rio de Janeiro,Brazil,Burundi,BDI,0,0,0,0,1,0,1,10488002,0.95,Africa
2016,Rio de Janeiro,Brazil,Cambodia,CAM,0,0,0,0,1,0,1,15766290,0.63,Asia
2016,Rio de Janeiro,Brazil,Cameroon,CMR,0,0,0,0,1,0,1,23926549,0.42,Africa
2016,Rio de Janeiro,Brazil,Canada,CAN,8,10,11,29,80,73,153,36109487,42.37,North America
2016,Rio de Janeiro,Brazil,Cape Verde,CPV,0,0,1,1,2,0,2,531140,37.65,Africa
2016,Rio de Janeiro,Brazil,Central African Republic,CAF,0,0,0,0,1,0,1,4537683,2.2,Africa
2016,Rio de Janeiro,Brazil,Chile,CHI,0,0,0,0,7,8,15,18209072,8.24,South America
2016,Rio de Janeiro,Brazil,China,CHN,107,81,51,239,161,146,307,1378665000,2.23,Asia
2016,Rio de Janeiro,Brazil,Tanzania,TAN,0,0,0,0,1,0,1,53049231,0.00,Africa
2016,Rio de Janeiro,Brazil,Colombia,COL,2,5,10,17,26,13,39,48175048,8.1,South America
2016,Rio de Janeiro,Brazil,Congo,CGO,0,0,0,0,1,0,1,4980996,2.01,Africa
2016,Rio de Janeiro,Brazil,Costa Rica,CRC,0,0,0,0,2,1,3,4899336,6.12,North America
1992,Barcelona,Spain,Unified Team,EUN,16,14,15,45,50,11,61,,,Europe
2016,Rio de Janeiro,Brazil,Croatia,CRO,2,2,1,5,12,7,19,4174349,45.52,Europe
2016,Rio de Janeiro,Brazil,Cuba,CUB,8,1,6,15,16,6,22,11335108,19.41,North America
2016,Rio de Janeiro,Brazil,Cyprus,CYP,0,0,0,0,1,1,2,1170189,17.09,Europe
2016,Rio de Janeiro,Brazil,Czech Republic,CZE,1,2,4,7,23,14,37,10566332,35.02,Europe
2016,Rio de Janeiro,Brazil,Denmark,DEN,1,2,4,7,13,8,21,5728010,36.66,Europe
2016,Rio de Janeiro,Brazil,Dominican Republic,DOM,0,0,0,0,2,0,2,10397738,1.92,North America
1972,Heidelberg,Germany,Yugoslavia,YUG,1,1,2,4,15,7,22,,,Europe
2016,Rio de Janeiro,Brazil,Ecuador,ECU,0,0,0,0,4,1,5,16491116,3.03,South America
2016,Rio de Janeiro,Brazil,Egypt,EGY,3,5,4,12,34,11,45,94447071,4.76,Africa
2016,Rio de Janeiro,Brazil,El Salvador,ESA,0,0,0,0,1,0,1,6356137,1.57,North America
2016,Rio de Janeiro,Brazil,Estonia,EST,0,0,0,0,2,4,6,1315790,45.6,Europe
2016,Rio de Janeiro,Brazil,Ethiopia,ETH,0,1,0,1,4,1,5,103603461,0.48,Africa
2016,Rio de Janeiro,Brazil,Faroe Islands,FRO,0,0,0,0,0,1,1,48173,207.59,Europe
2016,Rio de Janeiro,Brazil,Fiji,FIJ,0,0,0,0,1,1,2,872406,22.93,Oceania
2016,Rio de Janeiro,Brazil,Finland,FIN,1,1,1,3,19,7,26,5495303,47.31,Europe
2016,Rio de Janeiro,Brazil,France,FRA,9,5,14,28,80,42,122,66724104,18.28,Europe
2016,Rio de Janeiro,Brazil,Gabon,GAB,0,0,0,0,1,0,1,2007882,4.98,Africa
2016,Rio de Janeiro,Brazil,Gambia,GAM,0,0,0,0,1,0,1,2149134,4.65,Africa
2016,Rio de Janeiro,Brazil,Georgia,GEO,1,0,0,1,3,2,5,3727505,13.41,Europe
2016,Rio de Janeiro,Brazil,Germany,GER,18,25,14,57,89,66,155,82348669,18.82,Europe
2016,Rio de Janeiro,Brazil,Ghana,GHA,0,0,0,0,3,0,3,28481947,1.05,Africa
2016,Rio de Janeiro,Brazil,Great Britain,GBR,64,39,44,147,151,100,251,65611593,38.26,Europe
2016,Rio de Janeiro,Brazil,Greece,GRE,5,4,4,13,44,16,60,10775971,55.68,Europe
2016,Rio de Janeiro,Brazil,Guatemala,GUA,0,0,0,0,1,0,1,15827690,0.63,North America
2016,Rio de Janeiro,Brazil,Guinea,GUY,0,0,0,0,1,0,1,11738434,0.85,Africa
2016,Rio de Janeiro,Brazil,Guinea-Bissau,GBS,0,0,0,0,1,0,1,1782434,5.61,Africa
2016,Rio de Janeiro,Brazil,Haiti,HAI,0,0,0,0,1,0,1,10839976,0.92,North America
2016,Rio de Janeiro,Brazil,Honduras,HON,0,0,0,0,2,0,2,9270794,2.16,North America
2016,Rio de Janeiro,Brazil,Hong Kong,HKG,2,2,2,6,9,15,24,7336600,32.71,Asia
2016,Rio de Janeiro,Brazil,Hungary,HUN,1,8,9,18,19,24,43,9814023,43.81,Europe
2016,Rio de Janeiro,Brazil,Iceland,ISL,0,0,0,0,3,2,5,335439,149.06,Europe
2016,Rio de Janeiro,Brazil,India,IND,2,1,1,4,16,3,19,1324517250,0.14,Asia
1980,Arnhem,Netherlands,Yugoslavia,YUG,4,5,9,18,25,6,31,,,Europe
2016,Rio de Janeiro,Brazil,Indonesia,INA,0,0,1,1,6,3,9,261556386,0.34,Asia
2016,Rio de Janeiro,Brazil,Islamic Republic of Iran,IRI,8,9,7,24,85,23,108,79563991,13.57,Asia
2016,Rio de Janeiro,Brazil,Iraq,IRQ,2,3,0,5,12,2,14,36610632,3.82,Asia
2016,Rio de Janeiro,Brazil,Ireland,IRL,4,4,3,11,30,14,44,4755335,92.53,Europe
2016,Rio de Janeiro,Brazil,Israel,ISR,0,0,3,3,17,16,33,8546000,38.61,Asia
2016,Rio de Janeiro,Brazil,Italy,ITA,10,14,15,39,60,40,100,60627498,16.49,Europe
2016,Rio de Janeiro,Brazil,Jamaica,JAM,0,0,0,0,2,1,3,2906242,10.32,North America
2016,Rio de Janeiro,Brazil,Japan,JPN,0,10,14,24,86,46,132,126994511,10.39,Asia
2016,Rio de Janeiro,Brazil,Jordan,JOR,0,2,1,3,7,3,10,9554286,10.47,Asia
2016,Rio de Janeiro,Brazil,Kazakhstan,KAZ,1,1,0,2,7,4,11,17794055,6.18,Europe
2016,Rio de Janeiro,Brazil,Kenya,KEN,3,1,2,6,7,2,9,49051531,1.83,Africa
2016,Rio de Janeiro,Brazil,Republic of Korea,KOR,7,11,17,35,53,29,82,51217803,16.01,Asia
1984,"Stoke Mandeville, New York","Great Britain, United States of America",Yugoslavia,YUG,11,10,11,32,25,5,30,,,Europe
2016,Rio de Janeiro,Brazil,Kuwait,KUW,1,0,0,1,6,0,6,3956862,15.16,Asia
2016,Rio de Janeiro,Brazil,Kyrgyzstan,KGZ,0,0,0,0,3,0,3,6079500,4.93,Asia
2016,Rio de Janeiro,Brazil,Lao People's Democratic Republic,LAO,0,0,0,0,1,0,1,6845848,1.46,Asia
2016,Rio de Janeiro,Brazil,Latvia,LAT,2,0,2,4,6,5,11,1959537,56.14,Europe
2016,Rio de Janeiro,Brazil,Lesotho,LES,0,0,0,0,1,1,2,2075041,9.64,Africa
2016,Rio de Janeiro,Brazil,Libya,LBA,0,0,0,0,1,2,3,6492160,4.62,Africa
2016,Rio de Janeiro,Brazil,Lithuania,LTU,2,1,0,3,12,1,13,2868231,45.32,Europe
2016,Rio de Janeiro,Brazil,Luxembourg,LUX,0,0,0,0,3,0,3,582014,51.55,Europe
1988,Seoul,Republic of Korea,Yugoslavia,YUG,4,4,11,19,30,4,34,,,Europe
2016,Rio de Janeiro,Brazil,Madagascar,MAD,0,0,0,0,1,0,1,24894370,0.4,Africa
2016,Rio de Janeiro,Brazil,Malawi,MAW,0,0,0,0,0,1,1,17205253,0.58,Africa
2016,Rio de Janeiro,Brazil,Malaysia,MAS,3,0,1,4,17,2,19,30684652,6.19,Asia
2016,Rio de Janeiro,Brazil,Mali,MLI,0,0,0,0,1,1,2,17965448,1.11,Africa
2016,Rio de Janeiro,Brazil,Malta,MLT,0,0,0,0,0,1,1,455356,21.96,Europe
2016,Rio de Janeiro,Brazil,Mauritius,MRI,0,0,0,0,1,1,2,1263473,15.83,Africa
2016,Rio de Janeiro,Brazil,Mexico,MEX,4,2,9,15,37,32,69,123333379,5.59,North America
2016,Rio de Janeiro,Brazil,Republic of Moldova,MDA,0,0,0,0,1,2,3,2802170,10.71,Europe
2016,Rio de Janeiro,Brazil,Mongolia,MGL,0,0,2,2,6,2,8,3056358,26.17,Asia
2016,Rio de Janeiro,Brazil,Montenegro,MNE,0,0,0,0,1,1,2,622303,32.14,Europe
2016,Rio de Janeiro,Brazil,Morocco,MAR,3,2,2,7,18,6,24,35126274,6.83,Africa
2016,Rio de Janeiro,Brazil,Mozambique,MOZ,0,0,1,1,0,1,1,27829930,0.36,Africa
2016,Rio de Janeiro,Brazil,Myanmar,MYA,0,0,0,0,2,0,2,53045199,0.38,Asia
2016,Rio de Janeiro,Brazil,Namibia,NAM,1,2,2,5,7,2,9,2358044,38.17,Africa
2016,Rio de Janeiro,Brazil,Nepal,NEP,0,0,0,0,1,1,2,27263430,0.73,Asia
2016,Rio de Janeiro,Brazil,Netherlands,NED,17,19,26,62,58,62,120,17030314,70.46,Europe
2016,Rio de Janeiro,Brazil,New Zealand,NZL,9,5,7,21,17,12,29,4714100,61.52,Oceania
2016,Rio de Janeiro,Brazil,Nicaragua,NCA,0,0,0,0,2,1,3,6303970,4.76,North America
2016,Rio de Janeiro,Brazil,Niger,NIG,0,0,0,0,1,1,2,20788789,0.96,Africa
2016,Rio de Janeiro,Brazil,Nigeria,NGR,8,2,2,12,9,13,22,185960244,1.18,Africa
2016,Rio de Janeiro,Brazil,North Macedonia,MKD,0,0,0,0,1,1,2,2080746,9.61,Europe
2016,Rio de Janeiro,Brazil,Norway,NOR,3,2,3,8,12,13,25,5234519,47.76,Europe
2016,Rio de Janeiro,Brazil,Oman,OMA,0,0,0,0,1,1,2,4479217,4.47,Asia
2016,Rio de Janeiro,Brazil,Pakistan,PAK,0,0,1,1,1,0,1,203631356,0.05,Asia
1996,Atlanta,United States of America,Yugoslavia,YUG,2,2,0,4,5,1,6,,,Europe
2016,Rio de Janeiro,Brazil,Panama,PAN,0,0,0,0,1,1,2,4037073,4.95,North America
2016,Rio de Janeiro,Brazil,Papua New Guinea,PNG,0,0,0,0,1,1,2,8271766,2.42,Oceania
2016,Rio de Janeiro,Brazil,Peru,PER,0,0,0,0,5,1,6,30926036,1.94,South America
2016,Rio de Janeiro,Brazil,Philippines,PHI,0,0,1,1,3,2,5,103663812,0.48,Asia
2016,Rio de Janeiro,Brazil,Poland,POL,9,18,12,39,54,36,90,37970087,23.7,Europe
2016,Rio de Janeiro,Brazil,Portugal,POR,0,0,4,4,25,12,37,10325452,35.83,Europe
2016,Rio de Janeiro,Brazil,Puerto Rico,PUR,0,0,0,0,3,1,4,3406672,11.74,North America
2016,Rio de Janeiro,Brazil,Qatar,QAT,0,2,0,2,2,1,3,2654379,11.3,Asia
2016,Rio de Janeiro,Brazil,Romania,ROU,0,0,1,1,9,3,12,19702267,6.09,Europe
2016,Rio de Janeiro,Brazil,Rwanda,RWA,0,0,0,0,1,12,13,11668829,11.14,Africa
2016,Rio de Janeiro,Brazil,Samoa,SAM,0,0,0,0,1,1,2,194540,102.81,Oceania
2016,Rio de Janeiro,Brazil,Sao Tome and Principe,STP,0,0,0,0,1,0,1,203221,49.21,Africa
2016,Rio de Janeiro,Brazil,Saudi Arabia,KSA,0,0,1,1,3,0,3,32443443,0.92,Asia
2016,Rio de Janeiro,Brazil,Senegal,SEN,0,0,0,0,1,1,2,14993514,1.33,Africa
2016,Rio de Janeiro,Brazil,Serbia,SRB,3,2,4,9,13,3,16,7058322,22.67,Europe
2016,Rio de Janeiro,Brazil,Seychelles,SEY,0,0,0,0,1,0,1,94677,105.62,Africa
2016,Rio de Janeiro,Brazil,Sierra Leone,SLE,0,0,0,0,1,0,1,7328846,1.36,Africa
2016,Rio de Janeiro,Brazil,Singapore,SGP,2,0,1,3,4,9,13,5607283,23.18,Asia
2016,Rio de Janeiro,Brazil,Slovakia,SVK,5,3,3,11,21,7,28,5430798,51.56,Europe
2016,Rio de Janeiro,Brazil,Slovenia,SLO,1,1,0,2,7,1,8,2065042,38.74,Europe
2016,Rio de Janeiro,Brazil,Somalia,SOM,0,0,0,0,1,0,1,14185635,0.7,Africa
2016,Rio de Janeiro,Brazil,South Africa,RSA,7,6,4,17,26,18,44,56207649,7.83,Africa
2016,Rio de Janeiro,Brazil,Spain,ESP,9,14,8,31,83,28,111,46484062,23.88,Europe
2016,Rio de Janeiro,Brazil,Sri Lanka,SRI,0,0,1,1,8,1,9,21203000,4.24,Asia
2016,Rio de Janeiro,Brazil,Suriname,SUR,0,0,0,0,1,0,1,564883,17.7,South America
2016,Rio de Janeiro,Brazil,Sweden,SWE,1,4,5,10,39,18,57,9923085,57.44,Europe
2016,Rio de Janeiro,Brazil,Switzerland,SUI,2,2,1,5,14,10,24,8373338,28.66,Europe
2016,Rio de Janeiro,Brazil,Syrian Arab Republic,SYR,0,0,0,0,1,1,2,17465567,1.15,Asia
2016,Rio de Janeiro,Brazil,Tajikistan,TJK,0,0,0,0,1,0,1,8663575,1.15,Asia
2000,Sydney,Australia,Yugoslavia,YUG,0,1,0,1,2,0,2,,,Europe
2016,Rio de Janeiro,Brazil,Thailand,THA,6,6,6,18,30,15,45,68971313,6.52,Asia
2016,Rio de Janeiro,Brazil,Timor-Leste,TLS,0,0,0,0,1,1,2,1219289,16.4,Asia
2016,Rio de Janeiro,Brazil,Togo,TOG,0,0,0,0,1,0,1,7509952,1.33,Africa
2016,Rio de Janeiro,Brazil,Tonga,TGA,0,0,0,0,1,1,2,101143,197.74,Oceania
2016,Rio de Janeiro,Brazil,Trinidad and Tobago,TTO,1,1,1,3,1,2,3,1377563,21.78,North America
2016,Rio de Janeiro,Brazil,Tunisia,TUN,7,6,6,19,14,17,31,11303942,27.42,Africa
2016,Rio de Janeiro,Brazil,Turkey,TUR,3,1,5,9,46,32,78,79827868,9.77,Europe
2016,Rio de Janeiro,Brazil,Turkmenistan,TKM,0,0,0,0,1,1,2,5662371,3.53,Asia
2016,Rio de Janeiro,Brazil,US Virgin Islands,ISV,0,0,0,0,1,0,1,107516,93.01,North America
2016,Rio de Janeiro,Brazil,Uganda,UGA,0,1,0,1,1,0,1,39649173,0.25,Africa
2016,Rio de Janeiro,Brazil,Ukraine,UKR,41,37,39,117,91,77,168,45004673,37.33,Europe
2016,Rio de Janeiro,Brazil,United Arab Emirates,UAE,2,4,1,7,12,6,18,9360975,19.23,Asia
2016,Rio de Janeiro,Brazil,United States of America,USA,40,44,31,115,154,124,278,323071755,8.6,North America
2016,Rio de Janeiro,Brazil,Uruguay,URU,0,0,0,0,3,1,4,3424139,11.68,South America
2016,Rio de Janeiro,Brazil,Uzbekistan,UZB,8,6,17,31,22,10,32,31847900,10.05,Asia
2016,Rio de Janeiro,Brazil,Venezuela,VEN,0,3,3,6,16,8,24,29851249,8.04,South America
2016,Rio de Janeiro,Brazil,Vietnam,VIE,1,1,2,4,7,4,11,93640435,1.17,Asia
2016,Rio de Janeiro,Brazil,Zimbabwe,ZIM,0,0,0,0,2,3,5,14030338,3.56,Africa
2020,Tokyo,Japan,Afghanistan,AFG,0,0,0,0,1,1,2,38928341,0.51,Asia
2020,Tokyo,Japan,Algeria,ALG,4,4,4,12,35,21,56,43851043,12.77,Africa
2020,Tokyo,Japan,Angola,ANG,0,0,0,0,1,1,2,32866268,0.61,Africa
2020,Tokyo,Japan,Argentina,ARG,0,5,4,9,40,19,59,45376763,13,South America
2020,Tokyo,Japan,Armenia,ARM,0,0,0,0,1,0,1,2963234,3.37,Europe
2020,Tokyo,Japan,Aruba,ARU,0,0,0,0,1,0,1,106766,93.66,North America
2020,Tokyo,Japan,Australia,AUS,21,29,30,80,101,80,181,25687041,70.46,Oceania
2020,Tokyo,Japan,Austria,AUT,1,5,3,9,18,7,25,8917205,28.04,Europe
2020,Tokyo,Japan,Azerbaijan,AZE,14,1,4,19,24,12,36,10110116,35.61,Europe
2020,Tokyo,Japan,Bahrain,BRN,0,0,0,0,1,1,2,1701583,11.75,Asia
2020,Tokyo,Japan,Barbados,BAR,0,0,0,0,1,0,1,287371,34.8,North America
2020,Tokyo,Japan,Belarus,BLR,5,1,1,7,12,7,19,9398861,20.22,Europe
2020,Tokyo,Japan,Belgium,BEL,4,3,8,15,25,9,34,11555997,29.42,Europe
2020,Tokyo,Japan,Benin,BEN,0,0,0,0,1,1,2,12123198,1.65,Africa
2020,Tokyo,Japan,Bermuda,BER,0,0,0,0,0,1,1,63903,156.49,North America
2020,Tokyo,Japan,Bhutan,BHU,0,0,0,0,2,1,3,771612,38.88,Asia
2020,Tokyo,Japan,Bosnia and Herzegovina,BIH,0,0,1,1,14,1,15,3280815,45.72,Europe
2020,Tokyo,Japan,Botswana,BOT,0,0,0,0,1,1,2,2351625,8.5,Africa
2020,Tokyo,Japan,Brazil,BRA,22,20,30,72,145,96,241,212559409,11.34,South America
2020,Tokyo,Japan,Bulgaria,BUL,0,2,0,2,2,2,4,6927288,5.77,Europe
2020,Tokyo,Japan,Burkina Faso,BUR,0,0,0,0,1,1,2,20903278,0.96,Africa
2020,Tokyo,Japan,Burundi,BDI,0,0,0,0,1,1,2,11890781,1.68,Africa
2020,Tokyo,Japan,Cambodia,CAM,0,0,0,0,1,0,1,16718971,0.6,Asia
2020,Tokyo,Japan,Cameroon,CMR,0,0,0,0,1,2,3,26545864,1.13,Africa
2020,Tokyo,Japan,Canada,CAN,5,10,6,21,57,72,129,38005238,33.94,North America
2020,Tokyo,Japan,Cape Verde,CPV,0,0,0,0,1,1,2,555988,35.97,Africa
2020,Tokyo,Japan,Central African Republic,CAF,0,0,0,0,0,1,1,4829764,2.07,Africa
2020,Tokyo,Japan,Chile,CHI,2,3,1,6,10,9,19,19116209,9.94,South America
1960,Rome,Italy,Zimbabwe,ZIM,2,1,2,5,0,1,1,3776679,0.00,Africa
2020,Tokyo,Japan,Colombia,COL,3,7,14,24,44,22,66,50882884,12.97,South America
2020,Tokyo,Japan,Congo,CGO,0,0,0,0,1,1,2,5518092,3.62,Africa
2020,Tokyo,Japan,Costa Rica,CRC,1,1,0,2,7,2,9,5094114,17.67,North America
1964,Tokyo,Japan,Zimbabwe,ZIM,10,5,2,17,4,2,6,4322854,0.00,Africa
2020,Tokyo,Japan,Croatia,CRO,0,3,4,7,16,6,22,4047200,54.36,Europe
2020,Tokyo,Japan,Cuba,CUB,4,1,1,6,13,4,17,11326616,15.01,North America
2020,Tokyo,Japan,Cyprus,CYP,1,0,1,2,1,2,3,1207361,24.85,Europe
2020,Tokyo,Japan,Czech Republic,CZE,2,3,3,8,19,10,29,10698896,27.11,Europe
2020,Tokyo,Japan,Democratic Republic of the Congo,COD,0,0,0,0,1,1,2,89561404,0.22,Africa
2020,Tokyo,Japan,Denmark,DEN,3,1,1,5,16,9,25,5831404,42.87,Europe
2020,Tokyo,Japan,Dominican Republic,DOM,0,0,0,0,3,2,5,10847904,4.61,North America
2020,Tokyo,Japan,Ecuador,ECU,1,0,2,3,5,3,8,17643060,4.53,South America
2020,Tokyo,Japan,Egypt,EGY,0,5,2,7,29,20,49,102334403,4.79,Africa
2020,Tokyo,Japan,El Salvador,ESA,0,0,1,1,2,1,3,6486201,4.63,North America
2020,Tokyo,Japan,Estonia,EST,0,0,0,0,4,1,5,1331057,37.56,Europe
2020,Tokyo,Japan,Ethiopia,ETH,1,0,0,1,2,1,3,114963583,0.26,Africa
2020,Tokyo,Japan,Faroe Islands,FRO,0,0,0,0,1,0,1,48865,204.65,Europe
2020,Tokyo,Japan,Fiji,FIJ,0,0,0,0,2,0,2,896444,22.31,Oceania
2020,Tokyo,Japan,Finland,FIN,1,3,1,5,11,5,16,5530719,28.93,Europe
2020,Tokyo,Japan,France,FRA,11,15,28,54,108,38,146,67391582,21.66,Europe
2020,Tokyo,Japan,Gabon,GAB,0,0,0,0,1,1,2,2225728,8.99,Africa
2020,Tokyo,Japan,Gambia,GAM,0,0,0,0,1,1,2,2416664,8.28,Africa
2020,Tokyo,Japan,Georgia,GEO,0,3,0,3,9,4,13,3714000,35,Europe
2020,Tokyo,Japan,Germany,GER,13,12,18,43,79,58,137,83240525,16.46,Europe
2020,Tokyo,Japan,Ghana,GHA,0,0,0,0,3,0,3,31072945,0.97,Africa
2020,Tokyo,Japan,Great Britain,GBR,41,38,45,124,124,97,221,67215293,32.88,Europe
2020,Tokyo,Japan,Greece,GRE,1,3,7,11,34,11,45,10715549,42,Europe
2020,Tokyo,Japan,Grenada,GRN,0,0,0,0,0,2,2,112519,177.75,North America
2020,Tokyo,Japan,Guatemala,GUA,0,0,0,0,1,1,2,16858333,1.19,North America
2020,Tokyo,Japan,Guinea,GUI,0,0,0,0,1,1,2,13132792,1.52,Africa
2020,Tokyo,Japan,Guinea-Bissau,GBS,0,0,0,0,1,0,1,1967998,5.08,Africa
2020,Tokyo,Japan,Guyana,GUY,0,0,0,0,1,0,1,786559,12.71,South America
2020,Tokyo,Japan,Haiti,HAI,0,0,0,0,1,0,1,11402533,0.88,North America
2020,Tokyo,Japan,Honduras,HON,0,0,0,0,1,0,1,9904608,1.01,North America
2020,Tokyo,Japan,Hong Kong,HKG,0,2,3,5,9,14,23,7481800,30.74,Asia
2020,Tokyo,Japan,Hungary,HUN,7,5,4,16,19,20,39,9749763,40,Europe
2020,Tokyo,Japan,Iceland,ISL,0,0,0,0,3,3,6,366425,163.74,Europe
2020,Tokyo,Japan,India,IND,5,8,6,19,40,14,54,1380004385,0.39,Asia
2020,Tokyo,Japan,Indonesia,INA,2,3,4,9,14,9,23,273523621,0.84,Asia
2020,Tokyo,Japan,Iraq,IRQ,0,1,2,3,14,5,19,40222503,4.72,Asia
2020,Tokyo,Japan,Ireland,IRL,4,2,1,7,15,16,31,4994724,62.07,Europe
2020,Tokyo,Japan,Islamic Republic of Iran,IRI,12,11,1,24,54,9,63,83992953,7.5,Asia
2020,Tokyo,Japan,Israel,ISR,6,2,1,9,15,18,33,9216900,35.8,Asia
2020,Tokyo,Japan,Italy,ITA,14,29,26,69,52,62,114,59554023,19.14,Europe
2020,Tokyo,Japan,Jamaica,JAM,0,0,0,0,2,2,4,2961161,13.51,North America
2020,Tokyo,Japan,Japan,JPN,13,15,23,51,153,109,262,125836021,20.82,Asia
2020,Tokyo,Japan,Jordan,JOR,4,0,1,5,6,4,10,10203140,9.8,Asia
2020,Tokyo,Japan,Kazakhstan,KAZ,1,3,1,5,16,10,26,18754440,13.86,Europe
2020,Tokyo,Japan,Kenya,KEN,0,0,1,1,4,5,9,53771300,1.67,Africa
2020,Tokyo,Japan,Kuwait,KUW,0,1,1,2,2,1,3,4270563,7.02,Asia
2020,Tokyo,Japan,Kyrgyzstan,KGZ,0,0,0,0,1,1,2,6591600,3.03,Asia
2020,Tokyo,Japan,Lao People's Democratic Republic,LAO,0,0,0,0,1,0,1,7275556,1.37,Asia
2020,Tokyo,Japan,Latvia,LAT,0,3,2,5,4,3,7,1901548,36.81,Europe
2020,Tokyo,Japan,Lebanon,LBN,0,0,0,0,1,0,1,6825442,1.47,Asia
2020,Tokyo,Japan,Lesotho,LES,0,0,0,0,0,1,1,2142252,4.67,Africa
2020,Tokyo,Japan,Liberia,LBR,0,0,0,0,1,1,2,5057677,3.95,Africa
2020,Tokyo,Japan,Libya,LBA,0,0,0,0,2,0,2,6871287,2.91,Africa
2020,Tokyo,Japan,Lithuania,LTU,0,0,3,3,10,1,11,2794700,39.36,Europe
2020,Tokyo,Japan,Luxembourg,LUX,0,0,0,0,1,0,1,632275,15.82,Europe
2020,Tokyo,Japan,Madagascar,MAD,0,0,0,0,0,1,1,27691019,0.36,Africa
2020,Tokyo,Japan,Malawi,MAW,0,0,0,0,0,1,1,19129955,0.52,Africa
2020,Tokyo,Japan,Malaysia,MAS,3,2,0,5,21,4,25,32365998,7.72,Asia
2020,Tokyo,Japan,Maldives,MDV,0,0,0,0,1,1,2,540542,37,Asia
2020,Tokyo,Japan,Mali,MLI,0,0,0,0,1,1,2,20250834,0.99,Africa
2020,Tokyo,Japan,Malta,MLT,0,0,0,0,1,1,2,525285,38.07,Europe
2020,Tokyo,Japan,Mauritius,MRI,0,0,0,0,1,3,4,1265740,31.6,Africa
2020,Tokyo,Japan,Mexico,MEX,7,2,13,22,31,29,60,128932753,4.65,North America
2020,Tokyo,Japan,Mongolia,MGL,1,0,0,1,7,4,11,3278292,33.55,Asia
2020,Tokyo,Japan,Montenegro,MNE,0,0,1,1,4,1,5,621718,80.42,Europe
2020,Tokyo,Japan,Morocco,MAR,4,4,3,11,23,13,36,36910558,9.75,Africa
2020,Tokyo,Japan,Mozambique,MOZ,0,0,0,0,1,1,2,31255435,0.64,Africa
2020,Tokyo,Japan,Namibia,NAM,0,1,1,2,2,1,3,2540916,11.81,Africa
2020,Tokyo,Japan,Nepal,NEP,0,0,0,0,0,1,1,29136808,0.34,Asia
2020,Tokyo,Japan,Netherlands,NED,25,17,17,59,33,41,74,17441139,42.43,Europe
2020,Tokyo,Japan,New Zealand,NZL,6,3,3,12,16,16,32,5084300,62.94,Oceania
2020,Tokyo,Japan,Nicaragua,NCA,0,0,0,0,1,1,2,6624554,3.02,North America
2020,Tokyo,Japan,Niger,NIG,0,0,0,0,1,1,2,24206636,0.83,Africa
2020,Tokyo,Japan,Nigeria,NGR,4,1,5,10,10,12,22,206139587,1.07,Africa
2020,Tokyo,Japan,North Macedonia,MKD,0,0,0,0,0,1,1,2083380,4.8,Europe
2020,Tokyo,Japan,Norway,NOR,2,0,2,4,5,10,15,5379475,27.88,Europe
2020,Tokyo,Japan,Oman,OMA,0,0,1,1,2,1,3,5106622,5.87,Asia
2020,Tokyo,Japan,Pakistan,PAK,1,0,0,1,1,1,2,220892331,0.09,Asia
1968,Tel Aviv,Israel,Zimbabwe,ZIM,6,7,7,20,7,7,14,4941901,0.00,Africa
2020,Tokyo,Japan,Panama,PAN,0,0,0,0,2,1,3,4314768,6.95,North America
2020,Tokyo,Japan,Papua New Guinea,PNG,0,0,0,0,1,1,2,8947027,2.24,Oceania
2020,Tokyo,Japan,Paraguay,PAR,0,0,0,0,1,1,2,7132530,2.8,South America
2020,Tokyo,Japan,China,CHN,96,60,51,207,120,136,256,1402112000,1.83,Asia
2020,Tokyo,Japan,Peru,PER,1,0,0,1,7,4,11,32971846,3.34,South America
2020,Tokyo,Japan,Philippines,PHI,0,0,0,0,4,0,4,109581085,0.37,Asia
2020,Tokyo,Japan,Poland,POL,7,6,12,25,55,36,91,37950802,23.98,Europe
2020,Tokyo,Japan,Portugal,POR,0,0,2,2,24,10,34,10305564,32.99,Europe
2020,Tokyo,Japan,Puerto Rico,PUR,0,0,0,0,2,1,3,3194034,9.39,North America
2020,Tokyo,Japan,Qatar,QAT,0,0,1,1,1,1,2,2881060,6.94,Asia
1972,Heidelberg,Germany,Zimbabwe,ZIM,3,5,4,12,6,7,13,5673914,0.00,Africa
2020,Tokyo,Japan,Republic of Korea,KOR,2,10,12,24,57,28,85,51780579,16.42,Asia
2020,Tokyo,Japan,Republic of Moldova,MDA,0,0,0,0,4,2,6,2617820,22.92,Europe
2020,Tokyo,Japan,Romania,ROU,0,1,1,2,8,1,9,19286123,4.67,Europe
2020,Tokyo,Japan,RPC,RPC,36,33,49,118,134,114,248,144104080,17.21,Europe
2020,Tokyo,Japan,Rwanda,RWA,0,0,0,0,1,13,14,12952209,10.81,Africa
2020,Tokyo,Japan,Sao Tome and Principe,STP,0,0,0,0,1,0,1,219161,45.63,Africa
2020,Tokyo,Japan,Saudi Arabia,KSA,0,0,1,1,5,2,7,34813867,2.01,Asia
2020,Tokyo,Japan,Senegal,SEN,0,0,0,0,2,1,3,16743930,1.79,Africa
2020,Tokyo,Japan,Serbia,SRB,2,3,1,6,13,7,20,6908224,28.95,Europe
2020,Tokyo,Japan,Sierra Leone,SLE,0,0,0,0,1,1,2,7976985,2.51,Africa
2020,Tokyo,Japan,Singapore,SGP,2,0,0,2,5,6,11,5685807,19.35,Asia
2020,Tokyo,Japan,Slovakia,SVK,5,2,4,11,21,7,28,5458827,51.29,Europe
2020,Tokyo,Japan,Slovenia,SLO,0,1,1,2,7,0,7,2100126,33.33,Europe
2020,Tokyo,Japan,Somalia,SOM,0,0,0,0,1,0,1,15893219,0.63,Africa
2020,Tokyo,Japan,South Africa,RSA,4,1,2,7,20,14,34,59308690,5.73,Africa
2020,Tokyo,Japan,Spain,ESP,9,15,12,36,93,44,137,47351567,28.93,Europe
2020,Tokyo,Japan,Sri Lanka,SRI,1,0,1,2,8,1,9,21919000,4.11,Asia
2020,Tokyo,Japan,St Vincent and the Grenadines,VIN,0,0,0,0,1,0,1,110947,90.13,North America
2020,Tokyo,Japan,Sweden,SWE,1,5,2,8,12,17,29,10353442,28.01,Europe
2020,Tokyo,Japan,Switzerland,SUI,7,4,3,14,8,13,21,8636896,24.31,Europe
2020,Tokyo,Japan,Syrian Arab Republic,SYR,0,0,0,0,1,2,3,17500657,1.71,Asia
2020,Tokyo,Japan,Tajikistan,TJK,0,0,0,0,1,0,1,9537642,1.05,Asia
2020,Tokyo,Japan,Thailand,THA,5,5,8,18,50,26,76,69799978,10.89,Asia
2020,Tokyo,Japan,Togo,TOG,0,0,0,0,0,1,1,8278737,1.21,Africa
2020,Tokyo,Japan,Tunisia,TUN,4,5,2,11,12,13,25,11818618,21.15,Africa
2020,Tokyo,Japan,Turkey,TUR,2,4,9,15,43,44,87,84339067,10.32,Europe
2020,Tokyo,Japan,Uganda,UGA,0,0,1,1,1,3,4,45741000,0.87,Africa
2020,Tokyo,Japan,Ukraine,UKR,24,47,27,98,80,59,139,44134693,31.49,Europe
2020,Tokyo,Japan,United Arab Emirates,UAE,1,1,1,3,7,5,12,9890400,12.13,Asia
2020,Tokyo,Japan,United Republic of Tanzania,TAN,0,0,0,0,1,1,2,59734213,0.33,Africa
2020,Tokyo,Japan,United States of America,USA,37,36,31,104,120,123,243,329484123,7.38,North America
2020,Tokyo,Japan,Uruguay,URU,0,0,0,0,1,1,2,3473727,5.76,South America
2020,Tokyo,Japan,Uzbekistan,UZB,8,5,6,19,25,19,44,34232050,12.85,Asia
2020,Tokyo,Japan,Venezuela,VEN,3,2,2,7,13,14,27,28435943,9.5,South America
2020,Tokyo,Japan,Vietnam,VIE,0,1,0,1,4,3,7,97338583,0.72,Asia
2020,Tokyo,Japan,US Virgin Islands,ISV,0,0,0,0,0,1,1,106290,94.08,North America
2020,Tokyo,Japan,Yemen,YEM,0,0,0,0,1,1,2,29825968,0.67,Asia
2020,Tokyo,Japan,Zambia,ZAM,0,0,0,0,0,1,1,18383956,0.54,Africa
2020,Tokyo,Japan,Zimbabwe,ZIM,0,0,0,0,0,2,2,14862927,1.35,Africa
