,Year,Host_City,Host_Country,Country,Country_Code,Gold,Silver,Bronze,M_Total,Men,Women,P_Total,Population
0,1960,Rome,Italy,Argentina,ARG,2,3,1,6,5,4,9,20481781.0
1,1960,Rome,Italy,Australia,AUS,3,6,1,10,10,1,11,10276477.0
2,1960,Rome,Italy,Austria,AUT,11,8,11,30,12,7,19,7047539.0
3,1960,Rome,Italy,Belgium,BEL,1,1,1,3,10,2,12,9153489.0
4,1960,Rome,Italy,Finland,FIN,1,0,0,1,1,0,1,4429634.0
5,1960,Rome,Italy,France,FRA,3,3,1,7,10,1,11,46621688.0
6,1960,Rome,Italy,Germany,GER,15,6,9,30,7,2,9,72814900.0
7,1960,Rome,Italy,Great Britain,GBR,20,15,20,55,29,13,42,52400000.0
8,1960,Rome,Italy,Ireland,IRL,2,0,0,2,0,1,1,2828600.0
9,1960,Rome,Italy,Israel,ISR,0,2,2,4,6,1,7,2114020.0
10,1960,Rome,Italy,Italy,ITA,29,28,23,80,23,4,27,50199700.0
11,1960,Rome,Italy,Malta,MLT,0,2,2,4,5,1,6,326550.0
12,1960,Rome,Italy,Netherlands,NED,3,6,0,9,11,2,13,11486631.0
13,1960,Rome,Italy,Norway,NOR,9,3,4,16,7,4,11,3581239.0
14,1960,Rome,Italy,Rhodesia,ZIM,2,1,2,5,0,1,1,
15,1960,Rome,Italy,Switzerland,SUI,1,3,0,4,5,1,6,5327827.0
16,1960,Rome,Italy,United States of America,USA,11,7,7,25,23,0,23,180671000.0
17,1964,Tokyo,Japan,Argentina,ARG,6,15,16,37,19,6,25,21824427.0
18,1964,Tokyo,Japan,Australia,AUS,12,11,7,30,13,4,17,11167000.0
19,1964,Tokyo,Japan,Austria,AUT,4,1,7,12,3,4,7,7223801.0
20,1964,Tokyo,Japan,Belgium,BEL,1,0,2,3,1,1,2,9378113.0
21,1964,Tokyo,Japan,Fiji,FIJ,0,0,0,0,1,0,1,450538.0
22,1964,Tokyo,Japan,France,FRA,4,2,5,11,13,0,13,49230585.0
23,1964,Tokyo,Japan,Germany,GER,5,2,5,12,8,1,9,75318337.0
24,1964,Tokyo,Japan,Great Britain,GBR,18,23,20,61,30,14,44,54000000.0
25,1964,Tokyo,Japan,Ireland,IRL,0,0,0,0,2,0,2,2866550.0
26,1964,Tokyo,Japan,Israel,ISR,7,3,11,21,16,3,19,2475000.0
27,1964,Tokyo,Japan,Italy,ITA,14,15,16,45,14,5,19,51675350.0
28,1964,Tokyo,Japan,Japan,JPN,1,5,4,10,14,2,16,96903000.0
29,1964,Tokyo,Japan,Malta,MLT,0,0,2,2,2,0,2,321250.0
30,1964,Tokyo,Japan,Netherlands,NED,4,6,4,14,4,3,7,12127120.0
31,1964,Tokyo,Japan,Rhodesia,ZIM,10,5,2,17,4,2,6,
32,1964,Tokyo,Japan,South Africa,RSA,8,8,3,19,5,4,9,18896303.0
33,1964,Tokyo,Japan,Sweden,SWE,0,0,1,1,1,0,1,7661354.0
34,1964,Tokyo,Japan,Switzerland,SUI,0,1,0,1,0,1,1,5789228.0
35,1964,Tokyo,Japan,United States of America,USA,50,41,32,123,45,20,65,191889000.0
36,1964,Tokyo,Japan,West Germany,FRG,0,0,0,0,0,1,1,
37,1968,Tel Aviv,Israel,Argentina,ARG,10,10,10,30,14,7,21,23168268.0
38,1968,Tel Aviv,Israel,Australia,AUS,15,16,7,38,23,12,35,12009000.0
39,1968,Tel Aviv,Israel,Austria,AUT,2,7,10,19,19,12,31,7415403.0
40,1968,Tel Aviv,Israel,Belgium,BEL,0,3,3,6,21,5,26,9618756.0
41,1968,Tel Aviv,Israel,Canada,CAN,6,6,7,19,18,7,25,20744000.0
42,1968,Tel Aviv,Israel,Denmark,DEN,0,0,0,0,7,1,8,4864883.0
43,1968,Tel Aviv,Israel,Ethiopia,ETH,0,0,0,0,2,0,2,26944386.0
44,1968,Tel Aviv,Israel,Finland,FIN,0,0,0,0,2,0,2,4626469.0
45,1968,Tel Aviv,Israel,France,FRA,13,10,9,32,40,14,54,51175507.0
46,1968,Tel Aviv,Israel,Great Britain,GBR,29,20,20,69,50,24,74,55211700.0
47,1968,Tel Aviv,Israel,India,IND,0,0,0,0,8,2,10,531513834.0
48,1968,Tel Aviv,Israel,Ireland,IRL,0,4,5,9,5,2,7,2915550.0
49,1968,Tel Aviv,Israel,Israel,ISR,18,21,23,62,38,16,54,2803000.0
50,1968,Tel Aviv,Israel,Italy,ITA,12,10,17,39,33,5,38,53235750.0
51,1968,Tel Aviv,Israel,Jamaica,JAM,3,1,1,5,7,4,11,1825873.0
52,1968,Tel Aviv,Israel,Japan,JPN,2,2,8,12,40,7,47,101011000.0
53,1968,Tel Aviv,Israel,Republic of Korea,KOR,0,0,0,0,5,0,5,30838302.0
54,1968,Tel Aviv,Israel,Malta,MLT,0,0,0,0,4,2,6,307900.0
55,1968,Tel Aviv,Israel,Netherlands,NED,12,4,4,20,24,11,35,12729721.0
56,1968,Tel Aviv,Israel,New Zealand,NZL,1,2,1,4,17,1,18,2748100.0
57,1968,Tel Aviv,Israel,Norway,NOR,5,3,1,9,18,9,27,3816486.0
58,1968,Tel Aviv,Israel,Rhodesia,ZIM,6,7,7,20,7,7,14,
59,1968,Tel Aviv,Israel,South Africa,RSA,9,10,7,26,5,3,8,20942147.0
60,1968,Tel Aviv,Israel,Spain,ESP,0,3,1,4,9,2,11,33113134.0
61,1968,Tel Aviv,Israel,Sweden,SWE,1,6,4,11,27,5,32,7912273.0
62,1968,Tel Aviv,Israel,Switzerland,SUI,0,2,6,8,32,2,34,6067714.0
63,1968,Tel Aviv,Israel,United States of America,USA,33,27,39,99,53,29,82,200706000.0
64,1968,Tel Aviv,Israel,West Germany,FRG,12,12,11,35,50,8,58,
65,1972,Heidelberg,Germany,Argentina,ARG,2,4,3,9,12,9,21,24653172.0
66,1972,Heidelberg,Germany,Australia,AUS,6,9,10,25,28,9,37,13177000.0
67,1972,Heidelberg,Germany,Austria,AUT,6,6,6,18,22,10,32,7544201.0
68,1972,Heidelberg,Germany,Bahamas,BAH,0,0,0,0,1,0,1,
69,1972,Heidelberg,Germany,Belgium,BEL,1,1,2,4,18,5,23,9711115.0
70,1972,Heidelberg,Germany,Brazil,BRA,0,0,0,0,8,0,8,99859388.0
71,1972,Heidelberg,Germany,Canada,CAN,5,6,8,19,27,13,40,22218463.0
72,1972,Heidelberg,Germany,Czechoslovakia,TCH,0,0,1,1,14,5,19,
73,1972,Heidelberg,Germany,Denmark,DEN,0,0,0,0,8,2,10,4991596.0
74,1972,Heidelberg,Germany,Egypt,EGY,0,0,0,0,1,0,1,36102670.0
75,1972,Heidelberg,Germany,Finland,FIN,0,2,1,3,20,4,24,4639657.0
76,1972,Heidelberg,Germany,France,FRA,10,8,15,33,42,19,61,52793151.0
77,1972,Heidelberg,Germany,Great Britain,GBR,16,15,21,52,48,25,73,56086065.0
78,1972,Heidelberg,Germany,"Hong Kong, China",HKG,0,1,1,2,10,0,10,4123600.0
79,1972,Heidelberg,Germany,Hungary,HUN,0,0,1,1,4,1,5,10398489.0
80,1972,Heidelberg,Germany,India,IND,1,0,0,1,7,3,10,581087255.0
81,1972,Heidelberg,Germany,Ireland,IRL,2,4,2,8,8,9,17,3036850.0
82,1972,Heidelberg,Germany,Israel,ISR,9,10,9,28,19,11,30,3148000.0
83,1972,Heidelberg,Germany,Italy,ITA,8,4,5,17,20,5,25,54381345.0
84,1972,Heidelberg,Germany,Jamaica,JAM,8,3,4,15,13,7,20,1935089.0
85,1972,Heidelberg,Germany,Japan,JPN,4,5,3,12,23,5,28,107188000.0
86,1972,Heidelberg,Germany,Kenya,KEN,1,0,0,1,4,0,4,12146070.0
87,1972,Heidelberg,Germany,Republic of Korea,KOR,4,2,1,7,7,1,8,33505406.0
88,1972,Heidelberg,Germany,Malaysia,MAS,0,0,0,0,4,0,4,11324277.0
89,1972,Heidelberg,Germany,Malta,MLT,0,0,0,0,5,3,8,302450.0
90,1972,Heidelberg,Germany,Mexico,MEX,0,0,0,0,7,0,7,54689944.0
91,1972,Heidelberg,Germany,Netherlands,NED,14,13,11,38,26,12,38,13328593.0
92,1972,Heidelberg,Germany,New Zealand,NZL,3,3,3,9,7,3,10,2903900.0
93,1972,Heidelberg,Germany,Norway,NOR,1,5,4,10,18,9,27,3933004.0
94,1972,Heidelberg,Germany,Peru,PER,0,0,0,0,1,0,1,14221954.0
95,1972,Heidelberg,Germany,Poland,POL,14,12,7,33,12,10,22,33055650.0
96,1972,Heidelberg,Germany,Rhodesia,ZIM,3,5,4,12,6,7,13,
97,1972,Heidelberg,Germany,Romania,ROU,0,0,0,0,1,0,1,20657957.0
98,1972,Heidelberg,Germany,South Africa,RSA,16,12,13,41,12,13,25,23281517.0
99,1972,Heidelberg,Germany,Spain,ESP,0,4,0,4,11,9,20,34604469.0
100,1972,Heidelberg,Germany,Sweden,SWE,5,6,6,17,30,8,38,8122300.0
101,1972,Heidelberg,Germany,Switzerland,SUI,3,2,4,9,32,4,36,6260956.0
102,1972,Heidelberg,Germany,Uganda,UGA,0,0,0,0,2,0,2,9929644.0
103,1972,Heidelberg,Germany,United States of America,USA,17,27,31,75,49,17,66,209896000.0
104,1972,Heidelberg,Germany,West Germany,FRG,28,17,22,67,52,23,75,
105,1972,Heidelberg,Germany,Yugoslavia,YUG,1,1,2,4,15,7,22,
106,1976,Toronto,Canada,Argentina,ARG,3,4,7,14,8,12,20,26264681.0
107,1976,Toronto,Canada,Australia,AUS,16,18,7,41,35,11,46,14033000.0
108,1976,Toronto,Canada,Austria,AUT,18,16,17,51,32,10,42,7565525.0
109,1976,Toronto,Canada,Bahamas,BAH,0,0,0,0,6,0,6,
110,1976,Toronto,Canada,Belgium,BEL,7,7,8,22,41,4,45,9818227.0
111,1976,Toronto,Canada,Brazil,BRA,0,1,0,1,21,2,23,109790943.0
112,1976,Toronto,Canada,Burma,MYA,1,1,1,3,4,0,4,
113,1976,Toronto,Canada,Canada,CAN,25,26,26,77,66,23,89,23449808.0
114,1976,Toronto,Canada,Colombia,COL,0,0,0,0,8,3,11,24608102.0
115,1976,Toronto,Canada,Denmark,DEN,3,0,3,6,19,2,21,5072596.0
116,1976,Toronto,Canada,Ecuador,ECU,0,0,0,0,3,0,3,7187794.0
117,1976,Toronto,Canada,Egypt,EGY,5,2,1,8,27,0,27,39422731.0
118,1976,Toronto,Canada,Ethiopia,ETH,0,0,0,0,1,0,1,33128151.0
119,1976,Toronto,Canada,Fiji,FIJ,0,0,0,0,9,0,9,587561.0
120,1976,Toronto,Canada,Finland,FIN,12,20,18,50,46,4,50,4725664.0
121,1976,Toronto,Canada,France,FRA,23,21,14,58,42,10,52,54220033.0
122,1976,Toronto,Canada,Great Britain,GBR,29,28,37,94,64,23,87,56211968.0
123,1976,Toronto,Canada,Greece,GRE,0,0,0,0,3,0,3,9188150.0
124,1976,Toronto,Canada,Guatemala,GUA,0,0,1,1,11,0,11,6269983.0
125,1976,Toronto,Canada,"Hong Kong, China",HKG,0,1,2,3,11,0,11,4518000.0
126,1976,Toronto,Canada,Hungary,HUN,1,0,1,2,2,0,2,10598677.0
127,1976,Toronto,Canada,Indonesia,INA,2,1,3,6,12,0,12,133966940.0
128,1976,Toronto,Canada,Ireland,IRL,4,10,6,20,8,11,19,3238050.0
129,1976,Toronto,Canada,Israel,ISR,40,13,16,69,50,9,59,3533000.0
130,1976,Toronto,Canada,Italy,ITA,2,5,11,18,22,2,24,55718260.0
131,1976,Toronto,Canada,Japan,JPN,10,6,3,19,30,4,34,112775000.0
132,1976,Toronto,Canada,Republic of Korea,KOR,1,2,1,4,7,0,7,35848523.0
133,1976,Toronto,Canada,Luxembourg,LUX,0,0,0,0,2,1,3,360731.0
134,1976,Toronto,Canada,Mexico,MEX,16,14,9,39,24,8,32,61242189.0
135,1976,Toronto,Canada,Netherlands,NED,45,25,14,84,41,17,58,13774037.0
136,1976,Toronto,Canada,New Zealand,NZL,7,1,5,13,11,1,12,3110500.0
137,1976,Toronto,Canada,Norway,NOR,9,6,4,19,26,15,41,4026152.0
138,1976,Toronto,Canada,Peru,PER,1,0,2,3,1,1,2,15838568.0
139,1976,Toronto,Canada,Poland,POL,24,17,12,53,23,14,37,34356300.0
140,1976,Toronto,Canada,South Africa,RSA,6,9,11,26,27,10,37,25836890.0
141,1976,Toronto,Canada,Spain,ESP,4,6,2,12,21,1,22,36137812.0
142,1976,Toronto,Canada,Sweden,SWE,21,28,25,74,56,13,69,8222286.0
143,1976,Toronto,Canada,Switzerland,SUI,9,12,10,31,40,9,49,6302504.0
144,1976,Toronto,Canada,Uganda,UGA,0,0,0,0,1,0,1,11042975.0
145,1976,Toronto,Canada,United States of America,USA,66,44,45,155,63,34,97,218035000.0
146,1976,Toronto,Canada,West Germany,FRG,37,34,26,97,76,17,93,
147,1980,Arnhem,Netherlands,Argentina,ARG,4,5,6,15,6,5,11,27896532.0
148,1980,Arnhem,Netherlands,Australia,AUS,12,21,22,55,40,12,52,14692000.0
149,1980,Arnhem,Netherlands,Austria,AUT,14,23,8,45,38,10,48,7549433.0
150,1980,Arnhem,Netherlands,Bahamas,BAH,0,1,2,3,2,4,6,
151,1980,Arnhem,Netherlands,Belgium,BEL,13,12,17,42,54,13,67,9859242.0
152,1980,Arnhem,Netherlands,Brazil,BRA,0,0,0,0,2,0,2,120694012.0
153,1980,Arnhem,Netherlands,Canada,CAN,64,35,31,130,60,34,94,24515667.0
154,1980,Arnhem,Netherlands,Colombia,COL,1,0,1,2,8,3,11,26900508.0
155,1980,Arnhem,Netherlands,Czechoslovakia,TCH,0,1,1,2,5,2,7,
156,1980,Arnhem,Netherlands,Denmark,DEN,6,4,7,17,32,10,42,5123027.0
157,1980,Arnhem,Netherlands,Egypt,EGY,4,7,3,14,26,7,33,43309063.0
158,1980,Arnhem,Netherlands,Ethiopia,ETH,0,0,0,0,1,0,1,35141703.0
159,1980,Arnhem,Netherlands,Finland,FIN,8,19,13,40,50,10,60,4779535.0
160,1980,Arnhem,Netherlands,France,FRA,28,26,31,85,76,21,97,55161510.0
161,1980,Arnhem,Netherlands,Great Britain,GBR,47,32,21,100,65,31,96,56314216.0
162,1980,Arnhem,Netherlands,Greece,GRE,0,0,1,1,6,1,7,9642505.0
163,1980,Arnhem,Netherlands,"Hong Kong, China",HKG,0,1,2,3,11,0,11,5063100.0
164,1980,Arnhem,Netherlands,Iceland,ISL,1,0,1,2,8,4,12,228138.0
165,1980,Arnhem,Netherlands,Indonesia,INA,2,0,4,6,15,0,15,147447834.0
166,1980,Arnhem,Netherlands,Ireland,IRL,4,2,11,17,14,9,23,3412800.0
167,1980,Arnhem,Netherlands,Israel,ISR,13,18,15,46,40,7,47,3878000.0
168,1980,Arnhem,Netherlands,Italy,ITA,6,5,9,20,29,9,38,56433883.0
169,1980,Arnhem,Netherlands,Jamaica,JAM,7,7,5,19,6,7,13,2162839.0
170,1980,Arnhem,Netherlands,Japan,JPN,9,10,7,26,24,6,30,116807000.0
171,1980,Arnhem,Netherlands,Kenya,KEN,1,2,0,3,13,4,17,16417203.0
172,1980,Arnhem,Netherlands,Republic of Korea,KOR,2,2,1,5,12,0,12,38123775.0
173,1980,Arnhem,Netherlands,Kuwait,KUW,2,2,1,5,7,2,9,1368680.0
174,1980,Arnhem,Netherlands,Luxembourg,LUX,0,0,1,1,8,1,9,364150.0
175,1980,Arnhem,Netherlands,Malta,MLT,0,0,1,1,5,3,8,316645.0
176,1980,Arnhem,Netherlands,Mexico,MEX,20,16,6,42,19,8,27,67761367.0
177,1980,Arnhem,Netherlands,Netherlands,NED,33,31,36,100,78,30,108,14149800.0
178,1980,Arnhem,Netherlands,New Zealand,NZL,7,6,6,19,12,5,17,3112900.0
179,1980,Arnhem,Netherlands,Norway,NOR,15,13,8,36,36,17,53,4085620.0
180,1980,Arnhem,Netherlands,Poland,POL,75,50,52,177,50,30,80,35574150.0
181,1980,Arnhem,Netherlands,Spain,ESP,1,13,9,23,17,7,24,37491165.0
182,1980,Arnhem,Netherlands,Sudan,SUD,1,0,0,1,8,3,11,14507466.0
183,1980,Arnhem,Netherlands,Sweden,SWE,31,36,24,91,75,19,94,8310531.0
184,1980,Arnhem,Netherlands,Switzerland,SUI,9,10,10,29,51,14,65,6319408.0
185,1980,Arnhem,Netherlands,United States of America,USA,75,66,54,195,85,47,132,227225000.0
186,1980,Arnhem,Netherlands,West Germany,FRG,68,48,46,162,104,24,128,
187,1980,Arnhem,Netherlands,Yugoslavia,YUG,4,5,9,18,25,6,31,
188,1980,Arnhem,Netherlands,Zimbabwe,ZIM,0,8,4,12,2,3,5,7408630.0
189,1984,"Stoke Mandeville, New York","Great Britain, United States of America",Argentina,ARG,0,0,0,0,6,0,6,29737097.0
190,1984,"Stoke Mandeville, New York","Great Britain, United States of America",Australia,AUS,49,54,51,154,80,28,108,15544000.0
191,1984,"Stoke Mandeville, New York","Great Britain, United States of America",Austria,AUT,14,20,10,44,37,8,45,7561434.0
192,1984,"Stoke Mandeville, New York","Great Britain, United States of America",Bahamas,BAH,0,1,1,2,0,2,2,
193,1984,"Stoke Mandeville, New York","Great Britain, United States of America",Bahrain,BRN,0,0,2,2,10,2,12,407233.0
194,1984,"Stoke Mandeville, New York","Great Britain, United States of America",Belgium,BEL,21,23,14,58,30,5,35,9855372.0
195,1984,"Stoke Mandeville, New York","Great Britain, United States of America",Brazil,BRA,7,17,4,28,24,6,30,132383569.0
196,1984,"Stoke Mandeville, New York","Great Britain, United States of America",Burma,MYA,1,2,1,4,10,0,10,
197,1984,"Stoke Mandeville, New York","Great Britain, United States of America",Canada,CAN,87,82,69,238,120,46,166,25607053.0
198,1984,"Stoke Mandeville, New York","Great Britain, United States of America",People's Republic of China,CHN,2,12,8,22,17,6,23,1036825000.0
199,1984,"Stoke Mandeville, New York","Great Britain, United States of America",Denmark,DEN,30,13,16,59,26,10,36,5111619.0
200,1984,"Stoke Mandeville, New York","Great Britain, United States of America",East Germany,GDR,0,3,1,4,3,1,4,
201,1984,"Stoke Mandeville, New York","Great Britain, United States of America",Ecuador,ECU,0,0,0,0,2,0,2,8843463.0
202,1984,"Stoke Mandeville, New York","Great Britain, United States of America",Egypt,EGY,1,1,5,7,25,3,28,47968643.0
203,1984,"Stoke Mandeville, New York","Great Britain, United States of America",Faroe Islands,FRO,0,0,0,0,1,2,3,44895.0
204,1984,"Stoke Mandeville, New York","Great Britain, United States of America",Finland,FIN,18,14,27,59,49,8,57,4881803.0
205,1984,"Stoke Mandeville, New York","Great Britain, United States of America",France,FRA,71,69,46,186,78,37,115,56337675.0
206,1984,"Stoke Mandeville, New York","Great Britain, United States of America",Great Britain,GBR,107,112,112,331,156,68,224,56422072.0
207,1984,"Stoke Mandeville, New York","Great Britain, United States of America",Greece,GRE,0,0,0,0,2,1,3,9895801.0
208,1984,"Stoke Mandeville, New York","Great Britain, United States of America",Guatemala,GUA,0,0,0,0,4,0,4,7669863.0
209,1984,"Stoke Mandeville, New York","Great Britain, United States of America","Hong Kong, China",HKG,3,5,9,17,14,11,25,5397900.0
210,1984,"Stoke Mandeville, New York","Great Britain, United States of America",Hungary,HUN,12,13,3,28,22,4,26,10668095.0
211,1984,"Stoke Mandeville, New York","Great Britain, United States of America",Iceland,ISL,0,2,8,10,8,5,13,239511.0
212,1984,"Stoke Mandeville, New York","Great Britain, United States of America",India,IND,0,2,2,4,5,0,5,766833411.0
213,1984,"Stoke Mandeville, New York","Great Britain, United States of America",Indonesia,INA,0,1,1,2,6,2,8,161523353.0
214,1984,"Stoke Mandeville, New York","Great Britain, United States of America",Ireland,IRL,20,15,31,66,38,13,51,3532423.0
215,1984,"Stoke Mandeville, New York","Great Britain, United States of America",Israel,ISR,11,21,12,44,41,6,47,4159000.0
216,1984,"Stoke Mandeville, New York","Great Britain, United States of America",Italy,ITA,9,19,14,42,47,13,60,56576718.0
217,1984,"Stoke Mandeville, New York","Great Britain, United States of America",Jamaica,JAM,0,0,0,0,1,0,1,2306367.0
218,1984,"Stoke Mandeville, New York","Great Britain, United States of America",Japan,JPN,9,7,8,24,27,10,37,120083000.0
219,1984,"Stoke Mandeville, New York","Great Britain, United States of America",Jordan,JOR,0,1,2,3,6,3,9,2784457.0
220,1984,"Stoke Mandeville, New York","Great Britain, United States of America",Kenya,KEN,1,1,1,3,11,2,13,19146403.0
221,1984,"Stoke Mandeville, New York","Great Britain, United States of America",Republic of Korea,KOR,0,2,2,4,15,3,18,40405956.0
222,1984,"Stoke Mandeville, New York","Great Britain, United States of America",Kuwait,KUW,1,3,4,8,20,2,22,1652150.0
223,1984,"Stoke Mandeville, New York","Great Britain, United States of America",Liechtenstein,LIE,0,0,0,0,0,1,1,27028.0
224,1984,"Stoke Mandeville, New York","Great Britain, United States of America",Luxembourg,LUX,1,4,1,6,5,0,5,365998.0
225,1984,"Stoke Mandeville, New York","Great Britain, United States of America",Malta,MLT,0,0,0,0,1,0,1,330593.0
226,1984,"Stoke Mandeville, New York","Great Britain, United States of America",Mexico,MEX,6,14,17,37,40,14,54,74352631.0
227,1984,"Stoke Mandeville, New York","Great Britain, United States of America",Netherlands,NED,55,52,28,135,40,21,61,14424211.0
228,1984,"Stoke Mandeville, New York","Great Britain, United States of America",New Zealand,NZL,8,10,7,25,9,4,13,3227100.0
229,1984,"Stoke Mandeville, New York","Great Britain, United States of America",Norway,NOR,30,30,30,90,42,22,64,4140099.0
230,1984,"Stoke Mandeville, New York","Great Britain, United States of America",Papua New Guinea,PNG,0,0,0,0,4,0,4,3975950.0
231,1984,"Stoke Mandeville, New York","Great Britain, United States of America",Poland,POL,46,39,21,106,25,9,34,36904134.0
232,1984,"Stoke Mandeville, New York","Great Britain, United States of America",Portugal,POR,4,3,7,14,15,2,17,9996232.0
233,1984,"Stoke Mandeville, New York","Great Britain, United States of America",Spain,ESP,22,10,12,44,20,9,29,38330364.0
234,1984,"Stoke Mandeville, New York","Great Britain, United States of America",Sweden,SWE,83,43,34,160,79,18,97,8336605.0
235,1984,"Stoke Mandeville, New York","Great Britain, United States of America",Switzerland,SUI,18,13,12,43,35,8,43,6441865.0
236,1984,"Stoke Mandeville, New York","Great Britain, United States of America",Thailand,THA,0,0,0,0,4,0,4,51094870.0
237,1984,"Stoke Mandeville, New York","Great Britain, United States of America",Trinidad and Tobago,TTO,2,0,1,3,7,1,8,1155083.0
238,1984,"Stoke Mandeville, New York","Great Britain, United States of America",United States of America,USA,137,131,129,397,157,79,236,235825000.0
239,1984,"Stoke Mandeville, New York","Great Britain, United States of America",Venezuela,VEN,0,0,0,0,6,0,6,16876703.0
240,1984,"Stoke Mandeville, New York","Great Britain, United States of America",West Germany,FRG,81,76,75,232,109,33,142,
241,1984,"Stoke Mandeville, New York","Great Britain, United States of America",Yugoslavia,YUG,11,10,11,32,25,5,30,
242,1984,"Stoke Mandeville, New York","Great Britain, United States of America",Zimbabwe,ZIM,0,1,2,3,5,3,8,8562259.0
243,1988,Seoul,Republic of Korea,Argentina,ARG,0,7,2,9,18,17,35,31668939.0
244,1988,Seoul,Republic of Korea,Australia,AUS,23,34,38,95,148,27,175,16532200.0
245,1988,Seoul,Republic of Korea,Austria,AUT,13,7,15,35,37,6,43,7585317.0
246,1988,Seoul,Republic of Korea,Bahamas,BAH,0,0,0,0,2,2,4,
247,1988,Seoul,Republic of Korea,Bahrain,BRN,1,1,1,3,11,0,11,465198.0
248,1988,Seoul,Republic of Korea,Belgium,BEL,15,18,8,41,46,8,54,9901664.0
249,1988,Seoul,Republic of Korea,Brazil,BRA,4,9,14,27,47,12,59,143627505.0
250,1988,Seoul,Republic of Korea,Bulgaria,BUL,2,1,0,3,8,0,8,8981446.0
251,1988,Seoul,Republic of Korea,Canada,CAN,55,42,55,152,104,53,157,26791747.0
252,1988,Seoul,Republic of Korea,People's Republic of China,CHN,16,17,8,41,27,14,41,1101630000.0
253,1988,Seoul,Republic of Korea,Colombia,COL,0,0,0,0,16,0,16,31822527.0
254,1988,Seoul,Republic of Korea,Cyprus,CYP,0,0,0,0,6,0,6,736476.0
255,1988,Seoul,Republic of Korea,Czechoslovakia,TCH,0,1,0,1,1,0,1,
256,1988,Seoul,Republic of Korea,Denmark,DEN,23,19,22,64,27,21,48,5129516.0
257,1988,Seoul,Republic of Korea,Egypt,EGY,1,3,3,7,45,1,46,53399243.0
258,1988,Seoul,Republic of Korea,Faroe Islands,FRO,1,3,3,7,1,3,4,46833.0
259,1988,Seoul,Republic of Korea,Finland,FIN,11,23,16,50,50,11,61,4946481.0
260,1988,Seoul,Republic of Korea,France,FRA,46,44,50,140,95,21,116,57627106.0
261,1988,Seoul,Republic of Korea,Great Britain,GBR,65,65,54,184,169,55,224,56928327.0
262,1988,Seoul,Republic of Korea,Greece,GRE,0,1,3,4,4,0,4,10036983.0
263,1988,Seoul,Republic of Korea,Guatemala,GUA,1,0,0,1,1,0,1,8566331.0
264,1988,Seoul,Republic of Korea,"Hong Kong, China",HKG,0,2,7,9,31,11,42,5627600.0
265,1988,Seoul,Republic of Korea,Hungary,HUN,0,5,7,12,31,3,34,10596487.0
266,1988,Seoul,Republic of Korea,Iceland,ISL,2,2,7,11,9,5,14,249740.0
267,1988,Seoul,Republic of Korea,India,IND,0,0,0,0,1,1,2,837468938.0
268,1988,Seoul,Republic of Korea,Indonesia,INA,0,2,0,2,17,2,19,174975953.0
269,1988,Seoul,Republic of Korea,Islamic Republic of Iran,IRI,4,1,3,8,36,0,36,53077312.0
270,1988,Seoul,Republic of Korea,Ireland,IRL,13,11,18,42,42,11,53,3524949.0
271,1988,Seoul,Republic of Korea,Israel,ISR,15,14,16,45,47,15,62,4442000.0
272,1988,Seoul,Republic of Korea,Italy,ITA,16,15,27,58,69,26,95,56629288.0
273,1988,Seoul,Republic of Korea,Jamaica,JAM,1,4,3,8,2,3,5,2389415.0
274,1988,Seoul,Republic of Korea,Japan,JPN,17,12,17,46,109,34,143,122578000.0
275,1988,Seoul,Republic of Korea,Jordan,JOR,0,0,0,0,5,2,7,3256552.0
276,1988,Seoul,Republic of Korea,Kenya,KEN,0,4,1,5,9,3,12,22153685.0
277,1988,Seoul,Republic of Korea,Republic of Korea,KOR,40,35,19,94,205,21,226,42031247.0
278,1988,Seoul,Republic of Korea,Kuwait,KUW,5,5,7,17,27,3,30,2034850.0
279,1988,Seoul,Republic of Korea,Liechtenstein,LIE,0,0,0,0,1,1,2,28135.0
280,1988,Seoul,Republic of Korea,"Macao, China",MAC,0,0,0,0,6,1,7,
281,1988,Seoul,Republic of Korea,Malaysia,MAS,0,0,1,1,12,2,14,17022470.0
282,1988,Seoul,Republic of Korea,Mexico,MEX,8,9,7,24,28,5,33,80788725.0
283,1988,Seoul,Republic of Korea,Morocco,MAR,0,0,1,1,14,0,14,23903592.0
284,1988,Seoul,Republic of Korea,Netherlands,NED,30,24,29,83,76,34,110,14760094.0
285,1988,Seoul,Republic of Korea,New Zealand,NZL,2,4,11,17,11,5,16,3283400.0
286,1988,Seoul,Republic of Korea,Norway,NOR,11,11,15,37,28,6,34,4209488.0
287,1988,Seoul,Republic of Korea,Oman,OMA,0,0,0,0,9,0,9,1678119.0
288,1988,Seoul,Republic of Korea,Philippines,PHI,0,0,0,0,4,0,4,58794999.0
289,1988,Seoul,Republic of Korea,Poland,POL,23,25,33,81,39,7,46,37824487.0
290,1988,Seoul,Republic of Korea,Portugal,POR,3,5,6,14,7,6,13,10019610.0
291,1988,Seoul,Republic of Korea,Puerto Rico,PUR,1,2,0,3,12,1,13,3473898.0
292,1988,Seoul,Republic of Korea,Singapore,SGP,0,0,0,0,7,1,8,2846108.0
293,1988,Seoul,Republic of Korea,Spain,ESP,18,13,12,43,42,8,50,38766939.0
294,1988,Seoul,Republic of Korea,Sweden,SWE,42,38,23,103,79,24,103,8436489.0
295,1988,Seoul,Republic of Korea,Switzerland,SUI,12,12,11,35,33,8,41,6593386.0
296,1988,Seoul,Republic of Korea,Thailand,THA,0,1,0,1,10,0,10,54891520.0
297,1988,Seoul,Republic of Korea,Trinidad and Tobago,TTO,0,0,0,0,4,0,4,1204150.0
298,1988,Seoul,Republic of Korea,Tunisia,TUN,0,0,2,2,1,0,1,7880333.0
299,1988,Seoul,Republic of Korea,United States of America,USA,91,90,88,269,253,118,371,244499000.0
300,1988,Seoul,Republic of Korea,USSR,URS,21,20,15,56,16,6,22,
301,1988,Seoul,Republic of Korea,West Germany,FRG,76,65,52,193,145,43,188,
302,1988,Seoul,Republic of Korea,Yugoslavia,YUG,4,4,11,19,30,4,34,
303,1992,Barcelona,Spain,Algeria,ALG,0,0,0,0,8,0,8,27028330.0
304,1992,Barcelona,Spain,Argentina,ARG,1,1,0,2,26,1,27,33529320.0
305,1992,Barcelona,Spain,Australia,AUS,24,27,25,76,93,41,134,17495000.0
306,1992,Barcelona,Spain,Austria,AUT,5,4,13,22,31,5,36,7840709.0
307,1992,Barcelona,Spain,Bahrain,BRN,0,0,1,1,4,0,4,523082.0
308,1992,Barcelona,Spain,Belarus,BLR,0,0,0,0,1,0,1,10216000.0
309,1992,Barcelona,Spain,Belgium,BEL,5,5,7,17,64,9,73,10045158.0
310,1992,Barcelona,Spain,Brazil,BRA,3,0,4,7,31,10,41,154259382.0
311,1992,Barcelona,Spain,Bulgaria,BUL,1,2,0,3,5,2,7,8540164.0
312,1992,Barcelona,Spain,Burkina Faso,BUR,0,0,0,0,3,0,3,9297110.0
313,1992,Barcelona,Spain,Canada,CAN,28,21,26,75,89,49,138,28371264.0
314,1992,Barcelona,Spain,Chile,CHI,0,0,0,0,2,0,2,13719818.0
315,1992,Barcelona,Spain,People's Republic of China,CHN,11,7,7,25,13,11,24,1164970000.0
316,1992,Barcelona,Spain,Chinese Taipei,TPE,0,0,1,1,10,1,11,
317,1992,Barcelona,Spain,Colombia,COL,0,0,0,0,4,2,6,34422568.0
318,1992,Barcelona,Spain,Costa Rica,CRC,0,0,0,0,2,0,2,3286525.0
319,1992,Barcelona,Spain,Croatia,CRO,0,0,1,1,5,1,6,4575818.0
320,1992,Barcelona,Spain,Cuba,CUB,3,3,3,9,10,0,10,10736386.0
321,1992,Barcelona,Spain,Cyprus,CYP,0,0,0,0,4,0,4,800610.0
322,1992,Barcelona,Spain,Czechoslovakia,TCH,4,3,6,13,24,5,29,
323,1992,Barcelona,Spain,Denmark,DEN,12,22,12,46,22,21,43,5171370.0
324,1992,Barcelona,Spain,Dominican Republic,DOM,0,0,0,0,1,0,1,7408339.0
325,1992,Barcelona,Spain,Ecuador,ECU,0,0,0,0,3,0,3,10716131.0
326,1992,Barcelona,Spain,Egypt,EGY,7,6,7,20,41,0,41,58666812.0
327,1992,Barcelona,Spain,Estonia,EST,0,2,1,3,2,4,6,1533091.0
328,1992,Barcelona,Spain,Faroe Islands,FRO,0,1,0,1,1,2,3,46746.0
329,1992,Barcelona,Spain,Finland,FIN,8,6,11,25,54,13,67,5041992.0
330,1992,Barcelona,Spain,France,FRA,36,36,34,106,106,39,145,58851216.0
331,1992,Barcelona,Spain,Germany,GER,61,51,59,171,174,64,238,80624598.0
332,1992,Barcelona,Spain,Great Britain,GBR,40,47,41,128,156,52,208,57580402.0
333,1992,Barcelona,Spain,Greece,GRE,0,2,1,3,7,0,7,10399061.0
334,1992,Barcelona,Spain,"Hong Kong, China",HKG,3,4,4,11,16,5,21,5800500.0
335,1992,Barcelona,Spain,Hungary,HUN,4,3,4,11,34,9,43,10369341.0
336,1992,Barcelona,Spain,Iceland,ISL,3,2,12,17,8,4,12,261057.0
337,1992,Barcelona,Spain,Independent Paralympic Participants,IPP,4,3,1,8,13,3,16,
338,1992,Barcelona,Spain,India,IND,0,0,0,0,7,2,9,909307018.0
339,1992,Barcelona,Spain,Islamic Republic of Iran,IRI,1,2,1,4,25,4,29,58780376.0
340,1992,Barcelona,Spain,Iraq,IRQ,0,0,1,1,18,0,18,18402740.0
341,1992,Barcelona,Spain,Ireland,IRL,0,3,4,7,40,18,58,3558430.0
342,1992,Barcelona,Spain,Israel,ISR,2,4,5,11,56,6,62,5123000.0
343,1992,Barcelona,Spain,Italy,ITA,10,7,18,35,69,18,87,56797087.0
344,1992,Barcelona,Spain,Jamaica,JAM,0,1,2,3,2,2,4,2461047.0
345,1992,Barcelona,Spain,Japan,JPN,8,7,15,30,54,22,76,124425000.0
346,1992,Barcelona,Spain,Kenya,KEN,1,0,1,2,9,6,15,25326080.0
347,1992,Barcelona,Spain,Republic of Korea,KOR,11,15,18,44,64,2,66,43747962.0
348,1992,Barcelona,Spain,Kuwait,KUW,1,3,1,5,21,3,24,
349,1992,Barcelona,Spain,Latvia,LAT,0,0,0,0,2,0,2,2614338.0
350,1992,Barcelona,Spain,Liechtenstein,LIE,0,0,0,0,3,0,3,29552.0
351,1992,Barcelona,Spain,Lithuania,LTU,0,4,3,7,1,3,4,3700114.0
352,1992,Barcelona,Spain,Luxembourg,LUX,0,0,0,0,2,0,2,392175.0
353,1992,Barcelona,Spain,"Macao, China",MAC,0,0,0,0,2,0,2,
354,1992,Barcelona,Spain,Malaysia,MAS,0,1,2,3,10,0,10,19002660.0
355,1992,Barcelona,Spain,Mexico,MEX,0,1,10,11,9,10,19,87075136.0
356,1992,Barcelona,Spain,Morocco,MAR,0,0,0,0,5,0,5,25711410.0
357,1992,Barcelona,Spain,Myanmar,MYA,0,0,0,0,1,0,1,42401686.0
358,1992,Barcelona,Spain,Namibia,NAM,0,0,0,0,0,2,2,1516951.0
359,1992,Barcelona,Spain,Netherlands,NED,14,14,11,39,72,27,99,15184166.0
360,1992,Barcelona,Spain,New Zealand,NZL,5,1,0,6,9,4,13,3531700.0
361,1992,Barcelona,Spain,Nigeria,NGR,3,0,0,3,6,0,6,100161708.0
362,1992,Barcelona,Spain,Norway,NOR,13,13,7,33,33,5,38,4286401.0
363,1992,Barcelona,Spain,Oman,OMA,0,0,0,0,4,0,4,1983272.0
364,1992,Barcelona,Spain,Pakistan,PAK,0,0,0,0,2,0,2,113911126.0
365,1992,Barcelona,Spain,Panama,PAN,1,2,0,3,2,0,2,2575949.0
366,1992,Barcelona,Spain,Poland,POL,10,12,10,32,36,4,40,38363667.0
367,1992,Barcelona,Spain,Portugal,POR,3,3,3,9,26,4,30,9952494.0
368,1992,Barcelona,Spain,Puerto Rico,PUR,0,0,0,0,8,1,9,3585176.0
369,1992,Barcelona,Spain,Seychelles,SEY,0,0,0,0,2,0,2,70763.0
370,1992,Barcelona,Spain,Singapore,SGP,0,0,0,0,3,1,4,3230698.0
371,1992,Barcelona,Spain,Slovenia,SLO,2,0,1,3,7,1,8,1996498.0
372,1992,Barcelona,Spain,South Africa,RSA,4,1,3,8,9,1,10,38672611.0
373,1992,Barcelona,Spain,Spain,ESP,34,31,42,107,167,66,233,39157685.0
374,1992,Barcelona,Spain,Sweden,SWE,7,22,9,38,72,27,99,8668067.0
375,1992,Barcelona,Spain,Switzerland,SUI,6,16,13,35,36,5,41,6875364.0
376,1992,Barcelona,Spain,Syrian Arab Republic,SYR,0,0,0,0,2,0,2,13187669.0
377,1992,Barcelona,Spain,Tanzania,TAN,0,0,0,0,1,0,1,
378,1992,Barcelona,Spain,Thailand,THA,0,0,1,1,5,0,5,57811025.0
379,1992,Barcelona,Spain,Tunisia,TUN,0,0,0,0,1,0,1,8613855.0
380,1992,Barcelona,Spain,Turkey,TUR,0,0,0,0,1,0,1,55748946.0
381,1992,Barcelona,Spain,Unified Team,EUN,16,14,15,45,50,11,61,
382,1992,Barcelona,Spain,United Arab Emirates,UAE,0,0,0,0,1,0,1,2052892.0
383,1992,Barcelona,Spain,United States of America,USA,75,52,48,175,264,90,354,256514000.0
384,1992,Barcelona,Spain,Uruguay,URU,0,0,0,0,2,0,2,3154459.0
385,1992,Barcelona,Spain,Venezuela,VEN,0,0,1,1,9,1,10,20557694.0
386,1992,Barcelona,Spain,Yemen,YEM,0,0,0,0,3,0,3,12954157.0
387,1996,Atlanta,United States of America,Afghanistan,AFG,0,0,0,0,2,0,2,18853444.0
388,1996,Atlanta,United States of America,Algeria,ALG,2,2,3,7,9,0,9,29266415.0
389,1996,Atlanta,United States of America,Angola,ANG,0,0,0,0,2,0,2,14400722.0
390,1996,Atlanta,United States of America,Argentina,ARG,2,5,2,9,49,7,56,35246376.0
391,1996,Atlanta,United States of America,Armenia,ARM,0,0,0,0,5,0,5,3168213.0
392,1996,Atlanta,United States of America,Australia,AUS,42,37,27,106,99,62,161,18311000.0
393,1996,Atlanta,United States of America,Austria,AUT,6,6,10,22,44,5,49,7959017.0
394,1996,Atlanta,United States of America,Azerbaijan,AZE,0,0,0,0,2,0,2,7763000.0
395,1996,Atlanta,United States of America,Bahrain,BRN,0,0,0,0,6,0,6,578661.0
396,1996,Atlanta,United States of America,Belarus,BLR,3,3,7,13,11,4,15,10160000.0
397,1996,Atlanta,United States of America,Belgium,BEL,8,10,7,25,32,6,38,10156637.0
398,1996,Atlanta,United States of America,Bermuda,BER,0,0,0,0,0,2,2,60129.0
399,1996,Atlanta,United States of America,Bosnia and Herzegovina,BIH,0,0,0,0,3,0,3,3764419.0
400,1996,Atlanta,United States of America,Brazil,BRA,2,6,13,21,41,19,60,164614682.0
401,1996,Atlanta,United States of America,Bulgaria,BUL,0,1,1,2,4,2,6,8362826.0
402,1996,Atlanta,United States of America,Burkina Faso,BUR,0,0,0,0,3,0,3,10372734.0
403,1996,Atlanta,United States of America,Canada,CAN,24,21,24,69,94,38,132,29610218.0
404,1996,Atlanta,United States of America,Chile,CHI,0,0,0,0,2,0,2,14587367.0
405,1996,Atlanta,United States of America,People's Republic of China,CHN,16,13,10,39,27,10,37,1217550000.0
406,1996,Atlanta,United States of America,Chinese Taipei,TPE,1,0,2,3,13,1,14,
407,1996,Atlanta,United States of America,Colombia,COL,0,0,0,0,2,0,2,37076387.0
408,1996,Atlanta,United States of America,Côte d'Ivoire,CIV,2,0,0,2,2,0,2,
409,1996,Atlanta,United States of America,Croatia,CRO,0,0,0,0,2,3,5,4557097.0
410,1996,Atlanta,United States of America,Cuba,CUB,8,3,0,11,9,1,10,10939285.0
411,1996,Atlanta,United States of America,Cyprus,CYP,0,0,0,0,4,0,4,873426.0
412,1996,Atlanta,United States of America,Czech Republic,CZE,2,7,1,10,36,7,43,10315241.0
413,1996,Atlanta,United States of America,Denmark,DEN,7,17,17,41,25,20,45,5263074.0
414,1996,Atlanta,United States of America,Dominican Republic,DOM,1,0,0,1,2,0,2,7952766.0
415,1996,Atlanta,United States of America,Ecuador,ECU,0,0,0,0,2,0,2,11703169.0
416,1996,Atlanta,United States of America,Egypt,EGY,8,11,11,30,26,5,31,63601632.0
417,1996,Atlanta,United States of America,Estonia,EST,3,4,2,9,2,8,10,1415594.0
418,1996,Atlanta,United States of America,Faroe Islands,FRO,0,0,0,0,0,1,1,45624.0
419,1996,Atlanta,United States of America,Fiji,FIJ,0,0,0,0,2,0,2,784389.0
420,1996,Atlanta,United States of America,Finland,FIN,4,5,4,13,53,12,65,5124573.0
421,1996,Atlanta,United States of America,France,FRA,35,29,31,95,122,25,147,59753095.0
422,1996,Atlanta,United States of America,Germany,GER,40,58,51,149,153,78,231,81914831.0
423,1996,Atlanta,United States of America,Great Britain,GBR,39,42,41,122,165,83,248,58166950.0
424,1996,Atlanta,United States of America,Greece,GRE,1,1,3,5,16,0,16,10608800.0
425,1996,Atlanta,United States of America,Honduras,HON,0,0,0,0,2,0,2,5874814.0
426,1996,Atlanta,United States of America,"Hong Kong, China",HKG,5,5,5,15,19,5,24,6435500.0
427,1996,Atlanta,United States of America,Hungary,HUN,5,2,3,10,32,10,42,10311238.0
428,1996,Atlanta,United States of America,Iceland,ISL,5,4,5,14,6,4,10,268916.0
429,1996,Atlanta,United States of America,India,IND,0,0,0,0,9,0,9,982365248.0
430,1996,Atlanta,United States of America,Indonesia,INA,0,0,0,0,1,0,1,199901231.0
431,1996,Atlanta,United States of America,Islamic Republic of Iran,IRI,9,5,3,17,28,2,30,62294919.0
432,1996,Atlanta,United States of America,Ireland,IRL,1,3,6,10,46,17,63,3637510.0
433,1996,Atlanta,United States of America,Israel,ISR,0,4,5,9,37,3,40,5692000.0
434,1996,Atlanta,United States of America,Italy,ITA,11,20,14,45,59,19,78,56860281.0
435,1996,Atlanta,United States of America,Jamaica,JAM,0,0,1,1,2,1,3,2558631.0
436,1996,Atlanta,United States of America,Japan,JPN,14,10,13,37,58,23,81,125757000.0
437,1996,Atlanta,United States of America,Jordan,JOR,0,1,0,1,5,0,5,4732848.0
438,1996,Atlanta,United States of America,Kazakhstan,KAZ,0,0,0,0,13,0,13,15578227.0
439,1996,Atlanta,United States of America,Kenya,KEN,1,1,0,2,11,6,17,28589456.0
440,1996,Atlanta,United States of America,Republic of Korea,KOR,13,2,15,30,55,9,64,45524681.0
441,1996,Atlanta,United States of America,Kuwait,KUW,1,1,1,3,17,0,17,1626858.0
442,1996,Atlanta,United States of America,Kyrgyzstan,KGZ,0,0,0,0,2,0,2,4628400.0
443,1996,Atlanta,United States of America,Latvia,LAT,0,0,0,0,4,1,5,2457222.0
444,1996,Atlanta,United States of America,Libya,LBA,0,0,0,0,4,0,4,5036173.0
445,1996,Atlanta,United States of America,Lithuania,LTU,3,2,6,11,6,3,9,3601613.0
446,1996,Atlanta,United States of America,Luxembourg,LUX,0,0,0,0,1,0,1,414225.0
447,1996,Atlanta,United States of America,"Macao, China",MAC,0,0,0,0,1,0,1,
448,1996,Atlanta,United States of America,Malaysia,MAS,0,0,0,0,6,0,6,21017619.0
449,1996,Atlanta,United States of America,Mauritius,MRI,0,0,0,0,2,0,2,1133996.0
450,1996,Atlanta,United States of America,Mexico,MEX,3,5,4,12,28,10,38,93147045.0
451,1996,Atlanta,United States of America,Republic of Moldova,MDA,0,0,2,2,5,0,5,2946401.0
452,1996,Atlanta,United States of America,Morocco,MAR,0,0,0,0,4,0,4,27383472.0
453,1996,Atlanta,United States of America,Netherlands,NED,17,11,17,45,73,33,106,15530498.0
454,1996,Atlanta,United States of America,New Zealand,NZL,9,6,3,18,28,6,34,3732000.0
455,1996,Atlanta,United States of America,Nigeria,NGR,3,2,3,8,8,0,8,110668784.0
456,1996,Atlanta,United States of America,North Macedonia,MKD,0,0,0,0,1,0,1,1989441.0
457,1996,Atlanta,United States of America,Norway,NOR,9,7,4,20,35,7,42,4381336.0
458,1996,Atlanta,United States of America,Oman,OMA,0,0,0,0,3,0,3,2236652.0
459,1996,Atlanta,United States of America,Pakistan,PAK,0,0,0,0,1,0,1,127349293.0
460,1996,Atlanta,United States of America,Panama,PAN,2,0,0,2,1,0,1,2796291.0
461,1996,Atlanta,United States of America,Peru,PER,1,0,0,1,3,0,3,24753825.0
462,1996,Atlanta,United States of America,Poland,POL,13,14,8,35,49,12,61,38624370.0
463,1996,Atlanta,United States of America,Portugal,POR,6,4,4,14,29,6,35,10063945.0
464,1996,Atlanta,United States of America,Puerto Rico,PUR,0,0,0,0,3,2,5,3724655.0
465,1996,Atlanta,United States of America,Qatar,QAT,0,0,0,0,1,0,1,522531.0
466,1996,Atlanta,United States of America,Romania,ROU,0,0,0,0,1,0,1,22619004.0
467,1996,Atlanta,United States of America,Russian Federation,RUS,9,7,11,27,60,10,70,
468,1996,Atlanta,United States of America,Saudi Arabia,KSA,0,0,0,0,2,0,2,19033843.0
469,1996,Atlanta,United States of America,Serbia and Montenegro,SCG,0,0,0,0,3,1,4,
470,1996,Atlanta,United States of America,Sierra Leone,SLE,0,0,0,0,1,0,1,4312660.0
471,1996,Atlanta,United States of America,Singapore,SGP,0,0,0,0,1,2,3,3670704.0
472,1996,Atlanta,United States of America,Slovakia,SVK,2,4,5,11,23,5,28,5373361.0
473,1996,Atlanta,United States of America,Slovenia,SLO,0,2,3,5,13,1,14,1988628.0
474,1996,Atlanta,United States of America,South Africa,RSA,10,8,10,28,29,11,40,42241007.0
475,1996,Atlanta,United States of America,Spain,ESP,39,31,36,106,146,50,196,39889852.0
476,1996,Atlanta,United States of America,Sri Lanka,SRI,0,0,0,0,1,0,1,18367290.0
477,1996,Atlanta,United States of America,Sweden,SWE,12,14,11,37,83,27,110,8840998.0
478,1996,Atlanta,United States of America,Switzerland,SUI,9,6,6,21,36,9,45,7071850.0
479,1996,Atlanta,United States of America,Syrian Arab Republic,SYR,0,0,0,0,2,0,2,14754148.0
480,1996,Atlanta,United States of America,Thailand,THA,0,0,2,2,7,0,7,60130190.0
481,1996,Atlanta,United States of America,Tunisia,TUN,0,2,0,2,2,1,3,9267335.0
482,1996,Atlanta,United States of America,Uganda,UGA,0,0,0,0,1,0,1,21032817.0
483,1996,Atlanta,United States of America,Ukraine,UKR,1,4,2,7,25,5,30,51057800.0
484,1996,Atlanta,United States of America,United Arab Emirates,UAE,0,0,0,0,5,0,5,2539121.0
485,1996,Atlanta,United States of America,United States of America,USA,46,46,65,157,239,89,328,269394000.0
486,1996,Atlanta,United States of America,Uruguay,URU,0,0,1,1,1,0,1,3247383.0
487,1996,Atlanta,United States of America,Venezuela,VEN,0,0,0,0,4,0,4,22385650.0
488,1996,Atlanta,United States of America,Yugoslavia,YUG,2,2,0,4,5,1,6,
489,1996,Atlanta,United States of America,Zambia,ZAM,0,0,0,0,1,0,1,9339740.0
490,1996,Atlanta,United States of America,Zimbabwe,ZIM,0,0,0,0,2,0,2,11541215.0
491,2000,Sydney,Australia,Algeria,ALG,3,0,0,3,7,1,8,31042238.0
492,2000,Sydney,Australia,Angola,ANG,0,0,0,0,1,0,1,16395477.0
493,2000,Sydney,Australia,Argentina,ARG,0,2,3,5,31,12,43,36870796.0
494,2000,Sydney,Australia,Armenia,ARM,0,0,0,0,4,0,4,3069597.0
495,2000,Sydney,Australia,Australia,AUS,63,39,47,149,193,93,286,19153000.0
496,2000,Sydney,Australia,Austria,AUT,2,7,6,15,47,5,52,8011566.0
497,2000,Sydney,Australia,Azerbaijan,AZE,0,1,0,1,6,1,7,8048600.0
498,2000,Sydney,Australia,Bahrain,BRN,0,1,1,2,3,0,3,664610.0
499,2000,Sydney,Australia,Barbados,BAR,0,0,0,0,1,0,1,271511.0
500,2000,Sydney,Australia,Belarus,BLR,5,8,10,23,15,7,22,9979610.0
501,2000,Sydney,Australia,Belgium,BEL,1,4,4,9,25,5,30,10251250.0
502,2000,Sydney,Australia,Benin,BEN,0,0,0,0,1,0,1,6865946.0
503,2000,Sydney,Australia,Bermuda,BER,0,0,0,0,1,1,2,61833.0
504,2000,Sydney,Australia,Bosnia and Herzegovina,BIH,0,1,0,1,13,0,13,3751176.0
505,2000,Sydney,Australia,Brazil,BRA,6,10,6,22,52,11,63,174790339.0
506,2000,Sydney,Australia,Bulgaria,BUL,1,0,0,1,3,1,4,8170172.0
507,2000,Sydney,Australia,Burkina Faso,BUR,0,0,0,0,1,0,1,11607951.0
508,2000,Sydney,Australia,Cambodia,CAM,0,0,0,0,11,0,11,12155241.0
509,2000,Sydney,Australia,Canada,CAN,38,33,25,96,112,53,165,30685730.0
510,2000,Sydney,Australia,Chile,CHI,0,0,0,0,4,0,4,15342350.0
511,2000,Sydney,Australia,People's Republic of China,CHN,34,22,17,73,54,33,87,1262645000.0
512,2000,Sydney,Australia,Chinese Taipei,TPE,1,2,4,7,17,8,25,
513,2000,Sydney,Australia,Colombia,COL,0,0,0,0,3,0,3,39629965.0
514,2000,Sydney,Australia,Costa Rica,CRC,0,0,0,0,1,0,1,3962369.0
515,2000,Sydney,Australia,Côte d'Ivoire,CIV,1,0,1,2,2,0,2,
516,2000,Sydney,Australia,Croatia,CRO,0,0,0,0,10,5,15,4468302.0
517,2000,Sydney,Australia,Cuba,CUB,4,2,2,8,9,1,10,11126423.0
518,2000,Sydney,Australia,Cyprus,CYP,0,0,0,0,3,1,4,943288.0
519,2000,Sydney,Australia,Czech Republic,CZE,15,15,13,43,41,16,57,10255063.0
520,2000,Sydney,Australia,Denmark,DEN,8,8,14,30,26,12,38,5339616.0
521,2000,Sydney,Australia,Ecuador,ECU,0,0,0,0,2,1,3,12681123.0
522,2000,Sydney,Australia,Egypt,EGY,6,12,10,28,33,12,45,68831561.0
523,2000,Sydney,Australia,El Salvador,ESA,0,0,0,0,0,1,1,5887930.0
524,2000,Sydney,Australia,Estonia,EST,1,1,3,5,4,6,10,1396985.0
525,2000,Sydney,Australia,Faroe Islands,FRO,0,3,1,4,0,2,2,46738.0
526,2000,Sydney,Australia,Fiji,FIJ,0,0,0,0,4,0,4,811011.0
527,2000,Sydney,Australia,Finland,FIN,1,3,6,10,38,11,49,5176209.0
528,2000,Sydney,Australia,France,FRA,30,28,28,86,116,30,146,60912500.0
529,2000,Sydney,Australia,Germany,GER,16,41,38,95,181,69,250,82211508.0
530,2000,Sydney,Australia,Great Britain,GBR,41,43,47,131,140,74,214,58892514.0
531,2000,Sydney,Australia,Greece,GRE,4,4,3,11,41,3,44,10805808.0
532,2000,Sydney,Australia,Honduras,HON,0,0,0,0,1,0,1,6574510.0
533,2000,Sydney,Australia,"Hong Kong, China",HKG,8,3,7,18,22,6,28,6665000.0
534,2000,Sydney,Australia,Hungary,HUN,4,5,14,23,41,13,54,10210971.0
535,2000,Sydney,Australia,Iceland,ISL,2,0,2,4,5,1,6,281205.0
536,2000,Sydney,Australia,India,IND,0,0,0,0,4,0,4,1056575548.0
537,2000,Sydney,Australia,Individual Paralympic Athletes,IPA,0,0,0,0,2,0,2,
538,2000,Sydney,Australia,Indonesia,INA,0,0,0,0,4,0,4,211513822.0
539,2000,Sydney,Australia,Islamic Republic of Iran,IRI,12,4,7,23,36,4,40,65623397.0
540,2000,Sydney,Australia,Iraq,IRQ,0,0,0,0,3,0,3,23497589.0
541,2000,Sydney,Australia,Ireland,IRL,5,3,1,9,23,15,38,3805174.0
542,2000,Sydney,Australia,Israel,ISR,3,2,1,6,31,2,33,6289000.0
543,2000,Sydney,Australia,Italy,ITA,9,8,10,27,50,16,66,56942108.0
544,2000,Sydney,Australia,Jamaica,JAM,0,0,0,0,3,2,5,2654698.0
545,2000,Sydney,Australia,Japan,JPN,13,17,11,41,111,40,151,126843000.0
546,2000,Sydney,Australia,Jordan,JOR,1,0,0,1,5,2,7,5122495.0
547,2000,Sydney,Australia,Kazakhstan,KAZ,0,0,0,0,2,0,2,14883626.0
548,2000,Sydney,Australia,Kenya,KEN,1,1,2,4,8,5,13,31964557.0
549,2000,Sydney,Australia,Republic of Korea,KOR,18,7,7,32,82,7,89,47008111.0
550,2000,Sydney,Australia,Kuwait,KUW,0,1,4,5,22,4,26,2045123.0
551,2000,Sydney,Australia,Kyrgyzstan,KGZ,0,0,0,0,2,0,2,4898400.0
552,2000,Sydney,Australia,Lao People's Democratic Republic,LAO,0,0,0,0,1,1,2,5323701.0
553,2000,Sydney,Australia,Latvia,LAT,0,0,3,3,4,1,5,2367550.0
554,2000,Sydney,Australia,Lebanon,LBN,0,0,0,0,2,0,2,3842774.0
555,2000,Sydney,Australia,Lesotho,LES,0,0,0,0,1,1,2,2032805.0
556,2000,Sydney,Australia,Libya,LBA,0,0,1,1,16,1,17,5357893.0
557,2000,Sydney,Australia,Lithuania,LTU,0,2,1,3,14,3,17,3499536.0
558,2000,Sydney,Australia,"Macao, China",MAC,0,0,0,0,1,1,2,
559,2000,Sydney,Australia,Madagascar,MAD,0,0,0,0,1,0,1,15766806.0
560,2000,Sydney,Australia,Malaysia,MAS,0,0,0,0,8,2,10,23194252.0
561,2000,Sydney,Australia,Mali,MLI,0,0,0,0,1,0,1,10946448.0
562,2000,Sydney,Australia,Mauritania,MTN,0,0,0,0,1,1,2,2630217.0
563,2000,Sydney,Australia,Mexico,MEX,10,12,12,34,48,29,77,98899845.0
564,2000,Sydney,Australia,Republic of Moldova,MDA,0,0,0,0,6,0,6,2923783.0
565,2000,Sydney,Australia,Mongolia,MGL,0,0,0,0,2,0,2,2397417.0
566,2000,Sydney,Australia,Morocco,MAR,0,0,0,0,5,2,7,28793672.0
567,2000,Sydney,Australia,Netherlands,NED,12,9,9,30,68,33,101,15925513.0
568,2000,Sydney,Australia,New Zealand,NZL,6,8,4,18,36,6,42,3857700.0
569,2000,Sydney,Australia,Nigeria,NGR,7,1,5,13,18,11,29,122283853.0
570,2000,Sydney,Australia,North Macedonia,MKD,0,0,0,0,2,0,2,2034823.0
571,2000,Sydney,Australia,Norway,NOR,2,6,7,15,26,13,39,4490967.0
572,2000,Sydney,Australia,Oman,OMA,0,0,0,0,3,0,3,2267973.0
573,2000,Sydney,Australia,Pakistan,PAK,0,0,0,0,1,0,1,142343583.0
574,2000,Sydney,Australia,Palestine,PLE,0,0,1,1,1,1,2,
575,2000,Sydney,Australia,Panama,PAN,0,1,1,2,1,0,1,3030333.0
576,2000,Sydney,Australia,Papua New Guinea,PNG,0,0,0,0,3,0,3,5847590.0
577,2000,Sydney,Australia,Peru,PER,1,1,0,2,3,1,4,26459944.0
578,2000,Sydney,Australia,Philippines,PHI,0,0,1,1,1,1,2,77991757.0
579,2000,Sydney,Australia,Poland,POL,19,22,12,53,86,27,113,38258629.0
580,2000,Sydney,Australia,Portugal,POR,6,5,4,15,45,7,52,10289898.0
581,2000,Sydney,Australia,Puerto Rico,PUR,0,0,1,1,1,2,3,3810605.0
582,2000,Sydney,Australia,Qatar,QAT,0,0,0,0,3,0,3,592467.0
583,2000,Sydney,Australia,Romania,ROU,0,0,0,0,1,0,1,22442971.0
584,2000,Sydney,Australia,Russian Federation,RUS,12,11,12,35,69,20,89,
585,2000,Sydney,Australia,Rwanda,RWA,0,0,0,0,1,0,1,7933688.0
586,2000,Sydney,Australia,Samoa,SAM,0,0,0,0,1,0,1,174454.0
587,2000,Sydney,Australia,Saudi Arabia,KSA,0,0,0,0,4,0,4,20663840.0
588,2000,Sydney,Australia,Serbia and Montenegro,SCG,0,0,0,0,3,1,4,
589,2000,Sydney,Australia,Singapore,SGP,0,0,0,0,1,2,3,4027887.0
590,2000,Sydney,Australia,Slovakia,SVK,3,5,5,13,34,11,45,5388720.0
591,2000,Sydney,Australia,Slovenia,SLO,0,2,2,4,15,2,17,1988925.0
592,2000,Sydney,Australia,South Africa,RSA,13,12,13,38,50,16,66,44967713.0
593,2000,Sydney,Australia,Spain,ESP,38,30,38,106,157,52,209,40567864.0
594,2000,Sydney,Australia,Sri Lanka,SRI,0,0,0,0,3,0,3,18777606.0
595,2000,Sydney,Australia,Sweden,SWE,5,6,10,21,70,17,87,8872109.0
596,2000,Sydney,Australia,Switzerland,SUI,8,4,8,20,44,9,53,7184250.0
597,2000,Sydney,Australia,Syrian Arab Republic,SYR,0,0,0,0,3,1,4,16410847.0
598,2000,Sydney,Australia,Thailand,THA,5,4,2,11,35,6,41,62952639.0
599,2000,Sydney,Australia,Tonga,TGA,0,0,0,0,0,1,1,97962.0
600,2000,Sydney,Australia,Tunisia,TUN,6,4,1,11,8,2,10,9708347.0
601,2000,Sydney,Australia,Turkey,TUR,0,0,0,0,1,0,1,63240196.0
602,2000,Sydney,Australia,Turkmenistan,TKM,0,0,0,0,1,0,1,4516128.0
603,2000,Sydney,Australia,Uganda,UGA,0,0,0,0,0,1,1,23650159.0
604,2000,Sydney,Australia,Ukraine,UKR,3,20,14,37,49,18,67,49176500.0
605,2000,Sydney,Australia,United Arab Emirates,UAE,0,3,1,4,14,0,14,3134067.0
606,2000,Sydney,Australia,United States of America,USA,36,39,34,109,181,86,267,282162411.0
607,2000,Sydney,Australia,Uruguay,URU,0,0,0,0,1,1,2,3319734.0
608,2000,Sydney,Australia,Vanuatu,VAN,0,0,0,0,1,1,2,184964.0
609,2000,Sydney,Australia,Venezuela,VEN,0,0,1,1,8,2,10,24192449.0
610,2000,Sydney,Australia,Vietnam,VIE,0,0,0,0,1,1,2,79910411.0
611,2000,Sydney,Australia,Yugoslavia,YUG,0,1,0,1,2,0,2,
612,2000,Sydney,Australia,Zambia,ZAM,0,0,0,0,1,1,2,10415942.0
613,2000,Sydney,Australia,Zimbabwe,ZIM,1,0,0,1,2,1,3,11881482.0
614,2004,Athens,Greece,Afghanistan,AFG,0,0,0,0,1,2,3,24726689.0
615,2004,Athens,Greece,Algeria,ALG,6,2,5,13,14,4,18,32692153.0
616,2004,Athens,Greece,Angola,ANG,3,0,0,3,3,1,4,18758138.0
617,2004,Athens,Greece,Argentina,ARG,0,2,2,4,42,11,53,38491970.0
618,2004,Athens,Greece,Armenia,ARM,0,0,0,0,1,1,2,3000715.0
619,2004,Athens,Greece,Australia,AUS,26,39,36,101,89,56,145,20127400.0
620,2004,Athens,Greece,Austria,AUT,8,10,4,22,40,4,44,8171966.0
621,2004,Athens,Greece,Azerbaijan,AZE,2,1,1,4,8,1,9,8306500.0
622,2004,Athens,Greece,Bahrain,BRN,0,1,0,1,5,0,5,829846.0
623,2004,Athens,Greece,Bangladesh,BAN,0,0,0,0,1,0,1,136986429.0
624,2004,Athens,Greece,Barbados,BAR,0,0,0,0,1,0,1,275283.0
625,2004,Athens,Greece,Belarus,BLR,10,12,7,29,19,11,30,9730146.0
626,2004,Athens,Greece,Belgium,BEL,3,2,2,7,24,1,25,10421137.0
627,2004,Athens,Greece,Benin,BEN,0,0,0,0,1,1,2,7750003.0
628,2004,Athens,Greece,Bermuda,BER,0,0,0,0,0,2,2,63740.0
629,2004,Athens,Greece,Bosnia and Herzegovina,BIH,1,0,0,1,15,0,15,3764194.0
630,2004,Athens,Greece,Botswana,BOT,1,0,0,1,0,1,1,1765533.0
631,2004,Athens,Greece,Brazil,BRA,14,12,7,33,72,22,94,184006479.0
632,2004,Athens,Greece,Bulgaria,BUL,0,0,0,0,6,3,9,7716860.0
633,2004,Athens,Greece,Cambodia,CAM,0,0,0,0,1,1,2,13066475.0
634,2004,Athens,Greece,Canada,CAN,28,19,25,72,89,53,142,31940655.0
635,2004,Athens,Greece,Cape Verde,CPV,0,0,0,0,2,1,3,456619.0
636,2004,Athens,Greece,Central African Republic,CAF,0,0,0,0,1,0,1,3959883.0
637,2004,Athens,Greece,Chile,CHI,0,0,0,0,4,0,4,16014972.0
638,2004,Athens,Greece,People's Republic of China,CHN,63,46,32,141,108,89,197,1296075000.0
639,2004,Athens,Greece,Chinese Taipei,TPE,2,2,2,6,15,10,25,
640,2004,Athens,Greece,Colombia,COL,0,0,0,0,4,1,5,42075953.0
641,2004,Athens,Greece,Costa Rica,CRC,0,0,0,0,1,0,1,4225156.0
642,2004,Athens,Greece,Côte d'Ivoire,CIV,0,0,0,0,2,0,2,
643,2004,Athens,Greece,Croatia,CRO,0,0,4,4,12,5,17,4304600.0
644,2004,Athens,Greece,Cuba,CUB,2,2,7,11,19,5,24,11250369.0
645,2004,Athens,Greece,Cyprus,CYP,1,0,0,1,2,3,5,1010410.0
646,2004,Athens,Greece,Czech Republic,CZE,16,8,7,31,45,20,65,10197101.0
647,2004,Athens,Greece,Denmark,DEN,5,3,7,15,22,10,32,5404523.0
648,2004,Athens,Greece,Dominican Republic,DOM,0,0,0,0,1,1,2,8974444.0
649,2004,Athens,Greece,Ecuador,ECU,0,0,0,0,3,1,4,13596390.0
650,2004,Athens,Greece,Egypt,EGY,6,9,8,23,36,10,46,74172073.0
651,2004,Athens,Greece,El Salvador,ESA,0,0,0,0,1,1,2,6023801.0
652,2004,Athens,Greece,Estonia,EST,0,1,0,1,4,2,6,1362550.0
653,2004,Athens,Greece,Ethiopia,ETH,0,0,0,0,1,0,1,74239508.0
654,2004,Athens,Greece,Faroe Islands,FRO,0,0,1,1,0,1,1,47600.0
655,2004,Athens,Greece,Fiji,FIJ,0,0,0,0,1,1,2,817864.0
656,2004,Athens,Greece,Finland,FIN,4,1,3,8,31,23,54,5228172.0
657,2004,Athens,Greece,France,FRA,18,26,30,74,102,30,132,62704901.0
658,2004,Athens,Greece,Germany,GER,19,28,31,78,138,70,208,82516260.0
659,2004,Athens,Greece,Ghana,GHA,0,0,0,0,2,1,3,21272328.0
660,2004,Athens,Greece,Great Britain,GBR,35,30,29,94,99,65,164,59987905.0
661,2004,Athens,Greece,Greece,GRE,3,13,4,20,104,17,121,10955141.0
662,2004,Athens,Greece,Guatemala,GUA,0,0,0,0,1,1,2,12682108.0
663,2004,Athens,Greece,Guinea,GUY,0,0,0,0,1,0,1,8925729.0
664,2004,Athens,Greece,Honduras,HON,0,0,0,0,1,1,2,7282953.0
665,2004,Athens,Greece,"Hong Kong, China",HKG,11,7,1,19,15,9,24,6783500.0
666,2004,Athens,Greece,Hungary,HUN,1,8,10,19,25,12,37,10107146.0
667,2004,Athens,Greece,Iceland,ISL,1,3,0,4,2,1,3,292074.0
668,2004,Athens,Greece,India,IND,1,0,1,2,11,1,12,1129623466.0
669,2004,Athens,Greece,Indonesia,INA,0,0,0,0,3,0,3,223285666.0
670,2004,Athens,Greece,Islamic Republic of Iran,IRI,6,3,13,22,83,6,89,68951279.0
671,2004,Athens,Greece,Iraq,IRQ,1,0,1,2,8,0,8,26313838.0
672,2004,Athens,Greece,Ireland,IRL,0,3,1,4,32,8,40,4070262.0
673,2004,Athens,Greece,Israel,ISR,4,4,5,13,21,3,24,6809000.0
674,2004,Athens,Greece,Italy,ITA,4,8,7,19,61,14,75,57685327.0
675,2004,Athens,Greece,Jamaica,JAM,1,0,1,2,2,2,4,2725017.0
676,2004,Athens,Greece,Japan,JPN,17,15,20,52,106,54,160,127761000.0
677,2004,Athens,Greece,Jordan,JOR,0,1,1,2,5,5,10,5580241.0
678,2004,Athens,Greece,Kazakhstan,KAZ,0,0,0,0,6,2,8,15012984.0
679,2004,Athens,Greece,Kenya,KEN,3,1,3,7,8,8,16,35635267.0
680,2004,Athens,Greece,Republic of Korea,KOR,11,11,6,28,70,10,80,48082519.0
681,2004,Athens,Greece,Kuwait,KUW,1,2,3,6,13,1,14,2200498.0
682,2004,Athens,Greece,Kyrgyzstan,KGZ,0,0,0,0,3,0,3,5104700.0
683,2004,Athens,Greece,Latvia,LAT,1,1,1,3,3,4,7,2263122.0
684,2004,Athens,Greece,Lesotho,LES,0,0,0,0,1,1,2,2005953.0
685,2004,Athens,Greece,Libya,LBA,0,0,0,0,1,1,2,5710163.0
686,2004,Athens,Greece,Liechtenstein,LIE,0,0,0,0,1,0,1,34444.0
687,2004,Athens,Greece,Lithuania,LTU,1,1,5,7,16,4,20,3377075.0
688,2004,Athens,Greece,"Macao, China",MAC,0,0,0,0,1,0,1,
689,2004,Athens,Greece,Malaysia,MAS,0,0,0,0,15,4,19,25190647.0
690,2004,Athens,Greece,Mauritania,MTN,0,0,0,0,0,1,1,2939246.0
691,2004,Athens,Greece,Mauritius,MRI,0,0,0,0,1,1,2,1221003.0
692,2004,Athens,Greece,Mexico,MEX,14,10,10,34,36,41,77,104514934.0
693,2004,Athens,Greece,Republic of Moldova,MDA,0,0,0,0,3,0,3,2895147.0
694,2004,Athens,Greece,Mongolia,MGL,0,0,0,0,2,1,3,2496394.0
695,2004,Athens,Greece,Morocco,MAR,2,4,0,6,7,3,10,30115196.0
696,2004,Athens,Greece,Namibia,NAM,0,0,0,0,1,0,1,1907737.0
697,2004,Athens,Greece,Nepal,NEP,0,0,0,0,0,1,1,25419337.0
698,2004,Athens,Greece,Netherlands,NED,5,12,12,29,51,42,93,16281779.0
699,2004,Athens,Greece,New Zealand,NZL,6,1,3,10,28,8,36,4087500.0
700,2004,Athens,Greece,Nicaragua,NCA,0,0,0,0,1,0,1,5364930.0
701,2004,Athens,Greece,Niger,NIG,0,0,0,0,1,0,1,13125914.0
702,2004,Athens,Greece,Nigeria,NGR,5,4,3,12,6,8,14,135320420.0
703,2004,Athens,Greece,North Macedonia,MKD,0,1,0,1,2,1,3,2057044.0
704,2004,Athens,Greece,Norway,NOR,3,1,1,5,19,11,30,4591910.0
705,2004,Athens,Greece,Oman,OMA,0,0,0,0,2,0,2,2445524.0
706,2004,Athens,Greece,Pakistan,PAK,0,0,0,0,8,1,9,156664698.0
707,2004,Athens,Greece,Palestine,PLE,0,1,1,2,2,0,2,
708,2004,Athens,Greece,Panama,PAN,0,1,0,1,1,1,2,3269356.0
709,2004,Athens,Greece,Peru,PER,0,0,2,2,4,1,5,27624226.0
710,2004,Athens,Greece,Philippines,PHI,0,0,0,0,1,1,2,84710544.0
711,2004,Athens,Greece,Poland,POL,10,25,19,54,68,34,102,38182222.0
712,2004,Athens,Greece,Portugal,POR,2,5,5,12,22,7,29,10483861.0
713,2004,Athens,Greece,Puerto Rico,PUR,0,0,1,1,1,1,2,3826878.0
714,2004,Athens,Greece,Qatar,QAT,0,0,0,0,2,0,2,753332.0
715,2004,Athens,Greece,Romania,ROU,0,0,0,0,2,0,2,21451748.0
716,2004,Athens,Greece,Russian Federation,RUS,16,8,17,41,49,35,84,
717,2004,Athens,Greece,Rwanda,RWA,0,0,1,1,1,1,2,8680516.0
718,2004,Athens,Greece,Samoa,SAM,0,0,0,0,1,1,2,178597.0
719,2004,Athens,Greece,Saudi Arabia,KSA,0,0,0,0,6,0,6,23132686.0
720,2004,Athens,Greece,Senegal,SEN,0,0,0,0,1,1,2,10810086.0
721,2004,Athens,Greece,Serbia and Montenegro,SCG,0,0,2,2,5,0,5,
722,2004,Athens,Greece,Singapore,SGP,0,0,0,0,4,3,7,4166664.0
723,2004,Athens,Greece,Slovakia,SVK,5,3,4,12,28,8,36,5372280.0
724,2004,Athens,Greece,Slovenia,SLO,1,2,1,4,14,14,28,1997012.0
725,2004,Athens,Greece,South Africa,RSA,15,13,7,35,31,20,51,47291610.0
726,2004,Athens,Greece,Spain,ESP,20,27,24,71,118,34,152,42921895.0
727,2004,Athens,Greece,Sri Lanka,SRI,0,0,0,0,6,0,6,19387153.0
728,2004,Athens,Greece,Sudan,SUD,0,0,0,0,1,1,2,30214189.0
729,2004,Athens,Greece,Suriname,SUR,0,0,0,0,1,1,2,493680.0
730,2004,Athens,Greece,Sweden,SWE,8,7,6,21,32,9,41,8993531.0
731,2004,Athens,Greece,Switzerland,SUI,2,6,8,16,26,14,40,7389625.0
732,2004,Athens,Greece,Syrian Arab Republic,SYR,0,0,0,0,3,2,5,17827827.0
733,2004,Athens,Greece,Tajikistan,TJK,0,0,0,0,1,0,1,6662391.0
734,2004,Athens,Greece,Tanzania,TAN,0,0,0,0,1,1,2,
735,2004,Athens,Greece,Thailand,THA,3,6,6,15,33,10,43,64995303.0
736,2004,Athens,Greece,Tonga,TGA,0,0,0,0,0,1,1,100214.0
737,2004,Athens,Greece,Tunisia,TUN,8,7,3,18,14,8,22,10022278.0
738,2004,Athens,Greece,Turkey,TUR,1,0,1,2,8,1,9,67010930.0
739,2004,Athens,Greece,Turkmenistan,TKM,0,0,0,0,4,0,4,4703396.0
740,2004,Athens,Greece,Uganda,UGA,0,0,0,0,1,1,2,26821300.0
741,2004,Athens,Greece,Ukraine,UKR,24,12,19,55,57,31,88,47451626.0
742,2004,Athens,Greece,United Arab Emirates,UAE,1,1,2,4,10,0,10,4068577.0
743,2004,Athens,Greece,United States of America,USA,27,22,39,88,147,87,234,292805298.0
744,2004,Athens,Greece,Uruguay,URU,0,0,0,0,3,0,3,3321486.0
745,2004,Athens,Greece,Uzbekistan,UZB,0,0,0,0,1,0,1,25864350.0
746,2004,Athens,Greece,Venezuela,VEN,0,1,2,3,14,2,16,25996594.0
747,2004,Athens,Greece,Vietnam,VIE,0,0,0,0,0,4,4,83062819.0
748,2004,Athens,Greece,Zimbabwe,ZIM,1,0,0,1,1,1,2,12019911.0
749,2008,Beijing,China,Afghanistan,AFG,0,0,0,0,1,0,1,27722281.0
750,2008,Beijing,China,Algeria,ALG,4,3,8,15,21,7,28,34730604.0
751,2008,Beijing,China,Angola,ANG,0,3,0,3,5,1,6,21695636.0
752,2008,Beijing,China,Argentina,ARG,0,1,5,6,30,9,39,40080159.0
753,2008,Beijing,China,Armenia,ARM,0,0,0,0,0,1,1,2907615.0
754,2008,Beijing,China,Australia,AUS,23,29,27,79,86,70,156,21249200.0
755,2008,Beijing,China,Austria,AUT,4,1,1,6,34,4,38,8321496.0
756,2008,Beijing,China,Azerbaijan,AZE,2,3,5,10,17,1,18,8763400.0
757,2008,Beijing,China,Bahrain,BRN,0,0,0,0,2,1,3,1114645.0
758,2008,Beijing,China,Bangladesh,BAN,0,0,0,0,1,0,1,144304164.0
759,2008,Beijing,China,Barbados,BAR,0,0,0,0,1,0,1,279946.0
760,2008,Beijing,China,Belarus,BLR,5,7,1,13,19,11,30,9527985.0
761,2008,Beijing,China,Belgium,BEL,0,0,1,1,19,1,20,10709973.0
762,2008,Beijing,China,Benin,BEN,0,0,0,0,0,1,1,8696915.0
763,2008,Beijing,China,Bermuda,BER,0,0,0,0,1,0,1,65273.0
764,2008,Beijing,China,Bosnia and Herzegovina,BIH,0,1,0,1,14,1,15,3754261.0
765,2008,Beijing,China,Brazil,BRA,16,14,17,47,130,54,184,192030362.0
766,2008,Beijing,China,Bulgaria,BUL,0,1,1,2,4,4,8,7492561.0
767,2008,Beijing,China,Burkina Faso,BUR,0,0,0,0,1,0,1,14689725.0
768,2008,Beijing,China,Burundi,BDI,0,0,0,0,3,0,3,8126104.0
769,2008,Beijing,China,Cambodia,CAM,0,0,0,0,1,0,1,13883835.0
770,2008,Beijing,China,Canada,CAN,19,10,21,50,80,61,141,33247118.0
771,2008,Beijing,China,Cape Verde,CPV,0,0,0,0,0,1,1,480846.0
772,2008,Beijing,China,Central African Republic,CAF,0,0,0,0,1,0,1,4273368.0
773,2008,Beijing,China,Chile,CHI,0,0,0,0,3,1,4,16708255.0
774,2008,Beijing,China,People's Republic of China,CHN,89,70,52,211,196,135,331,1324655000.0
775,2008,Beijing,China,Chinese Taipei,TPE,1,0,1,2,10,7,17,
776,2008,Beijing,China,Colombia,COL,0,1,1,2,9,2,11,44254972.0
777,2008,Beijing,China,Costa Rica,CRC,0,0,0,0,2,0,2,4463123.0
778,2008,Beijing,China,Côte d'Ivoire,CIV,0,0,0,0,3,0,3,
779,2008,Beijing,China,Croatia,CRO,3,1,0,4,19,6,25,4309705.0
780,2008,Beijing,China,Cuba,CUB,5,3,6,14,26,5,31,11236975.0
781,2008,Beijing,China,Cyprus,CYP,1,2,1,4,3,1,4,1081568.0
782,2008,Beijing,China,Czech Republic,CZE,6,3,18,27,37,19,56,10384603.0
783,2008,Beijing,China,Denmark,DEN,3,2,4,9,22,15,37,5493621.0
784,2008,Beijing,China,Dominican Republic,DOM,0,0,0,0,1,0,1,9458079.0
785,2008,Beijing,China,Ecuador,ECU,0,0,0,0,1,1,2,14535740.0
786,2008,Beijing,China,Egypt,EGY,4,4,4,12,27,9,36,79636081.0
787,2008,Beijing,China,El Salvador,ESA,0,0,0,0,0,1,1,6131767.0
788,2008,Beijing,China,Estonia,EST,0,0,1,1,3,0,3,1337090.0
789,2008,Beijing,China,Ethiopia,ETH,0,0,0,0,2,0,2,82916236.0
790,2008,Beijing,China,Faroe Islands,FRO,0,0,0,0,0,1,1,47822.0
791,2008,Beijing,China,Fiji,FIJ,0,0,0,0,1,0,1,845356.0
792,2008,Beijing,China,Finland,FIN,2,2,2,6,25,6,31,5313399.0
793,2008,Beijing,China,France,FRA,12,21,19,52,80,39,119,64374979.0
794,2008,Beijing,China,Gabon,GAB,0,0,0,0,1,0,1,1518538.0
795,2008,Beijing,China,Georgia,GEO,0,0,0,0,1,0,1,3848449.0
796,2008,Beijing,China,Germany,GER,14,25,20,59,104,66,170,82110097.0
797,2008,Beijing,China,Ghana,GHA,0,0,0,0,1,1,2,23563832.0
798,2008,Beijing,China,Great Britain,GBR,42,29,31,102,130,75,205,61806995.0
799,2008,Beijing,China,Greece,GRE,5,9,10,24,52,15,67,11077841.0
800,2008,Beijing,China,Guatemala,GUA,0,0,0,0,1,0,1,13739299.0
801,2008,Beijing,China,Guinea,GUY,0,0,0,0,1,0,1,9738796.0
802,2008,Beijing,China,Haiti,HAI,0,0,0,0,0,1,1,9646570.0
803,2008,Beijing,China,Honduras,HON,0,0,0,0,1,0,1,7980955.0
804,2008,Beijing,China,"Hong Kong, China",HKG,5,3,3,11,10,12,22,6957800.0
805,2008,Beijing,China,Hungary,HUN,1,0,5,6,23,10,33,10038188.0
806,2008,Beijing,China,Iceland,ISL,0,0,0,0,4,1,5,317414.0
807,2008,Beijing,China,India,IND,0,0,0,0,5,0,5,1200669762.0
808,2008,Beijing,China,Indonesia,INA,0,0,0,0,2,1,3,235469755.0
809,2008,Beijing,China,Islamic Republic of Iran,IRI,5,6,3,14,68,4,72,72120608.0
810,2008,Beijing,China,Iraq,IRQ,0,1,1,2,17,2,19,28385739.0
811,2008,Beijing,China,Ireland,IRL,3,1,1,5,33,12,45,4489544.0
812,2008,Beijing,China,Israel,ISR,0,5,1,6,34,8,42,7308800.0
813,2008,Beijing,China,Italy,ITA,4,7,7,18,55,27,82,58826731.0
814,2008,Beijing,China,Jamaica,JAM,0,0,1,1,2,2,4,2781869.0
815,2008,Beijing,China,Japan,JPN,5,14,8,27,97,64,161,128063000.0
816,2008,Beijing,China,Jordan,JOR,0,2,2,4,7,5,12,6556473.0
817,2008,Beijing,China,Kazakhstan,KAZ,0,0,0,0,1,2,3,15776938.0
818,2008,Beijing,China,Kenya,KEN,5,3,1,9,10,3,13,39791984.0
819,2008,Beijing,China,Republic of Korea,KOR,10,8,13,31,57,20,77,49054708.0
820,2008,Beijing,China,Kuwait,KUW,0,0,0,0,7,1,8,2656010.0
821,2008,Beijing,China,Kyrgyzstan,KGZ,0,0,0,0,1,0,1,5318700.0
822,2008,Beijing,China,Lao People's Democratic Republic,LAO,0,0,1,1,1,0,1,6046630.0
823,2008,Beijing,China,Latvia,LAT,1,2,0,3,4,13,17,2177322.0
824,2008,Beijing,China,Lebanon,LBN,0,0,2,2,1,0,1,4764745.0
825,2008,Beijing,China,Lesotho,LES,0,0,0,0,0,1,1,1987130.0
826,2008,Beijing,China,Libya,LBA,0,0,0,0,2,1,3,6058740.0
827,2008,Beijing,China,Lithuania,LTU,0,2,0,2,12,14,26,3198231.0
828,2008,Beijing,China,Luxembourg,LUX,0,0,0,0,1,0,1,488650.0
829,2008,Beijing,China,"Macao, China",MAC,0,0,0,0,1,1,2,
830,2008,Beijing,China,Madagascar,MAD,0,0,0,0,1,0,1,19996476.0
831,2008,Beijing,China,Malaysia,MAS,0,0,1,1,8,3,11,27236003.0
832,2008,Beijing,China,Malta,MLT,0,0,0,0,1,0,1,409379.0
833,2008,Beijing,China,Mauritius,MRI,0,0,0,0,2,0,2,1244121.0
834,2008,Beijing,China,Mexico,MEX,10,3,7,20,30,37,67,110815272.0
835,2008,Beijing,China,Republic of Moldova,MDA,0,0,0,0,0,1,1,2867964.0
836,2008,Beijing,China,Mongolia,MGL,1,0,0,1,1,3,4,2631899.0
837,2008,Beijing,China,Montenegro,MNE,0,0,0,0,1,0,1,616969.0
838,2008,Beijing,China,Morocco,MAR,4,1,2,7,12,6,18,31536807.0
839,2008,Beijing,China,Myanmar,MYA,0,0,0,0,3,0,3,49929642.0
840,2008,Beijing,China,Namibia,NAM,0,0,1,1,1,0,1,2043382.0
841,2008,Beijing,China,Nepal,NEP,0,0,0,0,1,0,1,26666581.0
842,2008,Beijing,China,Netherlands,NED,5,10,7,22,33,46,79,16445593.0
843,2008,Beijing,China,New Zealand,NZL,5,3,4,12,20,9,29,4259800.0
844,2008,Beijing,China,Niger,NIG,0,0,0,0,1,0,1,15250913.0
845,2008,Beijing,China,Nigeria,NGR,4,4,1,9,14,9,23,150269622.0
846,2008,Beijing,China,North Macedonia,MKD,0,0,0,0,1,1,2,2067309.0
847,2008,Beijing,China,Norway,NOR,1,3,3,7,14,10,24,4768212.0
848,2008,Beijing,China,Oman,OMA,0,0,0,0,1,0,1,2750956.0
849,2008,Beijing,China,Pakistan,PAK,0,1,0,1,2,1,3,171648984.0
850,2008,Beijing,China,Palestine,PLE,0,0,0,0,2,0,2,
851,2008,Beijing,China,Panama,PAN,0,0,0,0,1,1,2,3516204.0
852,2008,Beijing,China,Papua New Guinea,PNG,0,1,0,1,1,1,2,6976200.0
853,2008,Beijing,China,Peru,PER,0,0,0,0,3,0,3,28562321.0
854,2008,Beijing,China,Philippines,PHI,0,0,0,0,1,2,3,90901967.0
855,2008,Beijing,China,Poland,POL,5,12,13,30,58,33,91,38125759.0
856,2008,Beijing,China,Portugal,POR,1,4,2,7,23,12,35,10558177.0
857,2008,Beijing,China,Puerto Rico,PUR,0,0,1,1,2,1,3,3760866.0
858,2008,Beijing,China,Qatar,QAT,0,0,0,0,2,0,2,1436670.0
859,2008,Beijing,China,Romania,ROU,0,1,0,1,2,2,4,20537875.0
860,2008,Beijing,China,Russian Federation,RUS,18,23,22,63,98,46,144,
861,2008,Beijing,China,Rwanda,RWA,0,0,0,0,1,0,1,9524532.0
862,2008,Beijing,China,Samoa,SAM,0,0,0,0,1,0,1,183270.0
863,2008,Beijing,China,Saudi Arabia,KSA,1,1,0,2,3,0,3,25888535.0
864,2008,Beijing,China,Senegal,SEN,0,0,0,0,1,1,2,12004700.0
865,2008,Beijing,China,Serbia,SRB,0,2,0,2,10,4,14,7350222.0
866,2008,Beijing,China,Singapore,SGP,1,1,2,4,2,4,6,4839396.0
867,2008,Beijing,China,Slovakia,SVK,2,3,1,6,26,9,35,5379233.0
868,2008,Beijing,China,Slovenia,SLO,0,1,2,3,14,16,30,2021316.0
869,2008,Beijing,China,South Africa,RSA,21,3,6,30,38,21,59,49779472.0
870,2008,Beijing,China,Spain,ESP,15,21,22,58,101,32,133,45954106.0
871,2008,Beijing,China,Sri Lanka,SRI,0,0,0,0,5,0,5,19983984.0
872,2008,Beijing,China,Suriname,SUR,0,0,0,0,1,0,1,517122.0
873,2008,Beijing,China,Sweden,SWE,5,3,4,12,38,25,63,9219637.0
874,2008,Beijing,China,Switzerland,SUI,3,2,6,11,18,8,26,7647675.0
875,2008,Beijing,China,Syrian Arab Republic,SYR,0,0,1,1,3,2,5,20664037.0
876,2008,Beijing,China,Tajikistan,TJK,0,0,0,0,0,1,1,7209924.0
877,2008,Beijing,China,Tanzania,TAN,0,0,0,0,1,0,1,
878,2008,Beijing,China,Thailand,THA,1,5,7,13,33,7,40,66530980.0
879,2008,Beijing,China,Timor-Leste,TLS,0,0,0,0,0,1,1,1055428.0
880,2008,Beijing,China,Tonga,TGA,0,0,0,0,1,0,1,103384.0
881,2008,Beijing,China,Tunisia,TUN,9,9,3,21,21,12,33,10414425.0
882,2008,Beijing,China,Turkey,TUR,1,0,1,2,8,8,16,70418612.0
883,2008,Beijing,China,Turkmenistan,TKM,0,0,0,0,1,2,3,4935765.0
884,2008,Beijing,China,Uganda,UGA,0,0,0,0,1,0,1,30431734.0
885,2008,Beijing,China,Ukraine,UKR,24,18,32,74,74,49,123,46258189.0
886,2008,Beijing,China,United Arab Emirates,UAE,0,1,0,1,6,1,7,7089486.0
887,2008,Beijing,China,United States of America,USA,36,35,28,99,120,87,207,304093966.0
888,2008,Beijing,China,Uruguay,URU,0,0,0,0,2,0,2,3340221.0
889,2008,Beijing,China,Uzbekistan,UZB,0,0,0,0,2,0,2,27302800.0
890,2008,Beijing,China,Vanuatu,VAN,0,0,0,0,1,0,1,224700.0
891,2008,Beijing,China,Venezuela,VEN,1,1,2,4,19,8,27,27635827.0
892,2008,Beijing,China,Vietnam,VIE,0,0,0,0,3,5,8,86243424.0
893,2008,Beijing,China,Zambia,ZAM,0,0,0,0,1,0,1,12848531.0
894,2008,Beijing,China,Zimbabwe,ZIM,0,0,0,0,1,1,2,12379553.0
895,2012,London,Great Britain,Afghanistan,AFG,0,0,0,0,1,0,1,31161378.0
896,2012,London,Great Britain,Albania,ALB,0,0,0,0,1,0,1,2900401.0
897,2012,London,Great Britain,Algeria,ALG,4,6,9,19,24,7,31,37383899.0
898,2012,London,Great Britain,Andorra,AND,0,0,0,0,1,0,1,82427.0
899,2012,London,Great Britain,Angola,ANG,1,0,1,2,2,2,4,25107925.0
900,2012,London,Great Britain,Antigua and Barbuda,ANT,0,0,0,0,1,0,1,90407.0
901,2012,London,Great Britain,Argentina,ARG,0,1,4,5,47,10,57,41733271.0
902,2012,London,Great Britain,Armenia,ARM,0,0,0,0,0,2,2,2884239.0
903,2012,London,Great Britain,Australia,AUS,32,23,30,85,88,70,158,22733465.0
904,2012,London,Great Britain,Austria,AUT,4,3,6,13,27,5,32,8429991.0
905,2012,London,Great Britain,Azerbaijan,AZE,4,5,3,12,16,5,21,9295784.0
906,2012,London,Great Britain,Bahrain,BRN,0,0,0,0,1,1,2,1299942.0
907,2012,London,Great Britain,Barbados,BAR,0,0,0,0,1,0,1,283698.0
908,2012,London,Great Britain,Belarus,BLR,5,2,3,10,15,14,29,9464495.0
909,2012,London,Great Britain,Belgium,BEL,3,1,3,7,31,9,40,11106932.0
910,2012,London,Great Britain,Benin,BEN,0,0,0,0,1,0,1,9729254.0
911,2012,London,Great Britain,Bermuda,BER,0,0,0,0,0,1,1,64798.0
912,2012,London,Great Britain,Bosnia and Herzegovina,BIH,1,0,0,1,11,1,12,3604972.0
913,2012,London,Great Britain,Brazil,BRA,21,14,8,43,110,68,178,199287292.0
914,2012,London,Great Britain,Brunei Darussalam,BRU,0,0,0,0,1,0,1,398997.0
915,2012,London,Great Britain,Bulgaria,BUL,0,2,1,3,4,4,8,7305888.0
916,2012,London,Great Britain,Burkina Faso,BUR,0,0,0,0,1,1,2,16571252.0
917,2012,London,Great Britain,Burundi,BDI,0,0,0,0,1,0,1,9245992.0
918,2012,London,Great Britain,Cambodia,CAM,0,0,0,0,0,1,1,14780454.0
919,2012,London,Great Britain,Cameroon,CMR,0,0,0,0,1,0,1,21485267.0
920,2012,London,Great Britain,Canada,CAN,7,15,9,31,87,57,144,34714222.0
921,2012,London,Great Britain,Cape Verde,CPV,0,0,0,0,1,0,1,505241.0
922,2012,London,Great Britain,Central African Republic,CAF,0,0,0,0,1,0,1,4436411.0
923,2012,London,Great Britain,Chile,CHI,1,0,0,1,4,3,7,17400359.0
924,2012,London,Great Britain,People's Republic of China,CHN,95,71,65,231,154,128,282,1350695000.0
925,2012,London,Great Britain,Chinese Taipei,TPE,0,1,2,3,9,9,18,
926,2012,London,Great Britain,Colombia,COL,0,2,0,2,30,7,37,46075721.0
927,2012,London,Great Britain,Comoros,COM,0,0,0,0,1,0,1,723865.0
928,2012,London,Great Britain,Costa Rica,CRC,0,0,0,0,2,0,2,4688003.0
929,2012,London,Great Britain,Côte d'Ivoire,CIV,0,0,0,0,3,1,4,
930,2012,London,Great Britain,Croatia,CRO,0,2,3,5,18,7,25,4267558.0
931,2012,London,Great Britain,Cuba,CUB,9,5,3,17,18,4,22,11257112.0
932,2012,London,Great Britain,Cyprus,CYP,0,1,0,1,2,1,3,1135046.0
933,2012,London,Great Britain,Czech Republic,CZE,1,6,4,11,31,15,46,10510785.0
934,2012,London,Great Britain,Denmark,DEN,1,0,4,5,15,13,28,5591572.0
935,2012,London,Great Britain,Djibouti,DJI,0,0,0,0,1,0,1,868136.0
936,2012,London,Great Britain,Dominican Republic,DOM,0,0,0,0,2,0,2,9930916.0
937,2012,London,Great Britain,DR Congo,COD,0,0,0,0,1,1,2,
938,2012,London,Great Britain,Ecuador,ECU,0,0,0,0,1,1,2,15474099.0
939,2012,London,Great Britain,Egypt,EGY,4,4,7,15,29,11,40,86422240.0
940,2012,London,Great Britain,El Salvador,ESA,0,0,0,0,1,0,1,6237922.0
941,2012,London,Great Britain,Estonia,EST,0,0,0,0,2,1,3,1322696.0
942,2012,London,Great Britain,Ethiopia,ETH,0,1,0,1,3,1,4,92726982.0
943,2012,London,Great Britain,Faroe Islands,FRO,0,0,0,0,1,0,1,47843.0
944,2012,London,Great Britain,Fiji,FIJ,1,0,0,1,1,0,1,865065.0
945,2012,London,Great Britain,Finland,FIN,4,1,1,6,21,14,35,5413971.0
946,2012,London,Great Britain,France,FRA,8,19,18,45,101,51,152,65659814.0
947,2012,London,Great Britain,Gabon,GAB,0,0,0,0,1,0,1,1749677.0
948,2012,London,Great Britain,Gambia,GAM,0,0,0,0,1,1,2,1905020.0
949,2012,London,Great Britain,Georgia,GEO,0,0,0,0,2,0,2,3728874.0
950,2012,London,Great Britain,Germany,GER,18,26,22,66,88,62,150,80425823.0
951,2012,London,Great Britain,Ghana,GHA,0,0,0,0,3,1,4,25996454.0
952,2012,London,Great Britain,Great Britain,GBR,34,43,43,120,177,109,286,63700215.0
953,2012,London,Great Britain,Greece,GRE,1,3,8,12,47,13,60,11045011.0
954,2012,London,Great Britain,Guatemala,GUA,0,0,0,0,1,0,1,14781942.0
955,2012,London,Great Britain,Guinea-Bissau,GBS,0,0,0,0,1,1,2,1604981.0
956,2012,London,Great Britain,Haiti,HAI,0,0,0,0,2,1,3,10250922.0
957,2012,London,Great Britain,Honduras,HON,0,0,0,0,1,0,1,8640692.0
958,2012,London,Great Britain,"Hong Kong, China",HKG,3,3,6,12,13,15,28,7150100.0
959,2012,London,Great Britain,Hungary,HUN,2,6,6,14,19,14,33,9920362.0
960,2012,London,Great Britain,Iceland,ISL,1,0,0,1,2,2,4,320716.0
961,2012,London,Great Britain,India,IND,0,1,0,1,10,0,10,1265780243.0
962,2012,London,Great Britain,Indonesia,INA,0,0,1,1,3,1,4,248451714.0
963,2012,London,Great Britain,Islamic Republic of Iran,IRI,10,7,7,24,70,7,77,75539881.0
964,2012,London,Great Britain,Iraq,IRQ,0,2,1,3,16,3,19,31890012.0
965,2012,London,Great Britain,Ireland,IRL,8,3,5,16,28,17,45,4599533.0
966,2012,London,Great Britain,Israel,ISR,1,2,5,8,18,7,25,7910500.0
967,2012,London,Great Britain,Italy,ITA,9,8,11,28,65,31,96,59539717.0
968,2012,London,Great Britain,Jamaica,JAM,1,0,0,1,2,1,3,2842128.0
969,2012,London,Great Britain,Japan,JPN,5,5,6,16,89,45,134,127629000.0
970,2012,London,Great Britain,Jordan,JOR,0,0,0,0,4,4,8,8089963.0
971,2012,London,Great Britain,Kazakhstan,KAZ,0,0,0,0,4,3,7,16792090.0
972,2012,London,Great Britain,Kenya,KEN,2,2,2,6,10,2,12,44343469.0
973,2012,London,Great Britain,Republic of Korea,KOR,9,9,9,27,60,28,88,50199853.0
974,2012,London,Great Britain,Korea DPR,PRK,0,0,0,0,1,0,1,
975,2012,London,Great Britain,Kuwait,KUW,0,0,0,0,6,0,6,3348852.0
976,2012,London,Great Britain,Kyrgyzstan,KGZ,0,0,0,0,1,0,1,5607200.0
977,2012,London,Great Britain,Lao People's Democratic Republic,LAO,0,0,0,0,1,0,1,6444527.0
978,2012,London,Great Britain,Latvia,LAT,1,1,0,2,6,2,8,2034319.0
979,2012,London,Great Britain,Lebanon,LBN,0,0,0,0,1,0,1,5537620.0
980,2012,London,Great Britain,Lesotho,LES,0,0,0,0,0,1,1,2014988.0
981,2012,London,Great Britain,Liberia,LBR,0,0,0,0,1,0,1,4135662.0
982,2012,London,Great Britain,Libya,LBA,0,0,0,0,2,0,2,6285751.0
983,2012,London,Great Britain,Lithuania,LTU,0,0,0,0,9,2,11,2987773.0
984,2012,London,Great Britain,"Macao, China",MAC,0,0,0,0,1,1,2,
985,2012,London,Great Britain,Madagascar,MAD,0,0,0,0,1,0,1,22346641.0
986,2012,London,Great Britain,Malaysia,MAS,0,1,1,2,16,6,22,29068189.0
987,2012,London,Great Britain,Mali,MLI,0,0,0,0,1,0,1,15979492.0
988,2012,London,Great Britain,Malta,MLT,0,0,0,0,1,0,1,420028.0
989,2012,London,Great Britain,Mauritania,MTN,0,0,0,0,1,1,2,3706555.0
990,2012,London,Great Britain,Mauritius,MRI,0,0,0,0,1,1,2,1255882.0
991,2012,London,Great Britain,Mexico,MEX,6,4,11,21,37,44,81,117274156.0
992,2012,London,Great Britain,Republic of Moldova,MDA,0,0,0,0,1,1,2,2859458.0
993,2012,London,Great Britain,Mongolia,MGL,0,0,0,0,3,3,6,2824698.0
994,2012,London,Great Britain,Montenegro,MNE,0,0,0,0,0,1,1,620601.0
995,2012,London,Great Britain,Morocco,MAR,3,0,3,6,24,6,30,33241898.0
996,2012,London,Great Britain,Mozambique,MOZ,0,0,0,0,1,1,2,24862673.0
997,2012,London,Great Britain,Myanmar,MYA,0,0,0,0,2,0,2,51413703.0
998,2012,London,Great Britain,Namibia,NAM,1,1,0,2,4,1,5,2194777.0
999,2012,London,Great Britain,Nepal,NEP,0,0,0,0,1,1,2,26989160.0
1000,2012,London,Great Britain,Netherlands,NED,10,10,19,39,39,49,88,16754962.0
1001,2012,London,Great Britain,New Zealand,NZL,6,7,4,17,11,12,23,4408100.0
1002,2012,London,Great Britain,Nicaragua,NCA,0,0,0,0,1,1,2,5982530.0
1003,2012,London,Great Britain,Niger,NIG,0,0,0,0,1,1,2,17795209.0
1004,2012,London,Great Britain,Nigeria,NGR,6,5,2,13,17,12,29,167228803.0
1005,2012,London,Great Britain,North Macedonia,MKD,1,0,0,1,1,1,2,2074275.0
1006,2012,London,Great Britain,Norway,NOR,3,2,3,8,13,9,22,5018573.0
1007,2012,London,Great Britain,Oman,OMA,0,0,0,0,2,0,2,3498031.0
1008,2012,London,Great Britain,Pakistan,PAK,0,0,0,0,2,0,2,187280125.0
1009,2012,London,Great Britain,Palestine,PLE,0,0,0,0,2,0,2,
1010,2012,London,Great Britain,Panama,PAN,0,0,0,0,1,1,2,3770635.0
1011,2012,London,Great Britain,Papua New Guinea,PNG,0,0,0,0,2,0,2,7631003.0
1012,2012,London,Great Britain,Peru,PER,0,0,0,0,1,0,1,29506790.0
1013,2012,London,Great Britain,Philippines,PHI,0,0,0,0,4,5,9,97212639.0
1014,2012,London,Great Britain,Poland,POL,14,13,9,36,64,35,99,38063164.0
1015,2012,London,Great Britain,Portugal,POR,0,1,2,3,22,8,30,10514844.0
1016,2012,London,Great Britain,Puerto Rico,PUR,0,0,0,0,2,0,2,3634488.0
1017,2012,London,Great Britain,Qatar,QAT,0,0,0,0,1,0,1,2196078.0
1018,2012,London,Great Britain,Romania,ROU,1,1,0,2,4,1,5,20058035.0
1019,2012,London,Great Britain,Russian Federation,RUS,36,38,28,102,120,61,181,
1020,2012,London,Great Britain,Rwanda,RWA,0,0,0,0,14,0,14,10549668.0
1021,2012,London,Great Britain,Samoa,SAM,0,0,0,0,1,1,2,189089.0
1022,2012,London,Great Britain,San Marino,SMR,0,0,0,0,1,0,1,32103.0
1023,2012,London,Great Britain,Saudi Arabia,KSA,0,1,0,1,4,0,4,29154906.0
1024,2012,London,Great Britain,Senegal,SEN,0,0,0,0,1,0,1,13401990.0
1025,2012,London,Great Britain,Serbia,SRB,2,3,0,5,9,4,13,7199077.0
1026,2012,London,Great Britain,Sierra Leone,SLE,0,0,0,0,1,0,1,6712586.0
1027,2012,London,Great Britain,Singapore,SGP,0,1,1,2,2,6,8,5312437.0
1028,2012,London,Great Britain,Slovakia,SVK,2,1,3,6,25,8,33,5407579.0
1029,2012,London,Great Britain,Slovenia,SLO,0,1,0,1,7,15,22,2057159.0
1030,2012,London,Great Britain,Solomon Islands,SOL,0,0,0,0,0,1,1,556066.0
1031,2012,London,Great Britain,South Africa,RSA,8,12,9,29,44,18,62,52832659.0
1032,2012,London,Great Britain,Spain,ESP,8,18,16,42,98,29,127,46773055.0
1033,2012,London,Great Britain,Sri Lanka,SRI,0,0,1,1,6,1,7,20425000.0
1034,2012,London,Great Britain,Suriname,SUR,0,0,0,0,1,0,1,541247.0
1035,2012,London,Great Britain,Sweden,SWE,4,4,4,12,40,19,59,9519374.0
1036,2012,London,Great Britain,Switzerland,SUI,3,6,4,13,15,10,25,7996861.0
1037,2012,London,Great Britain,Syrian Arab Republic,SYR,0,0,0,0,3,2,5,20438861.0
1038,2012,London,Great Britain,Tajikistan,TJK,0,0,0,0,1,0,1,7874838.0
1039,2012,London,Great Britain,Tanzania,TAN,0,0,0,0,1,0,1,
1040,2012,London,Great Britain,Thailand,THA,4,2,2,8,38,11,49,67835969.0
1041,2012,London,Great Britain,Timor-Leste,TLS,0,0,0,0,1,0,1,1133002.0
1042,2012,London,Great Britain,Tonga,TGA,0,0,0,0,1,0,1,102736.0
1043,2012,London,Great Britain,Trinidad and Tobago,TTO,0,0,0,0,1,1,2,1344814.0
1044,2012,London,Great Britain,Tunisia,TUN,9,5,5,19,18,13,31,10846993.0
1045,2012,London,Great Britain,Turkey,TUR,1,5,4,10,46,21,67,74651046.0
1046,2012,London,Great Britain,Turkmenistan,TKM,0,0,0,0,3,2,5,5267906.0
1047,2012,London,Great Britain,US Virgin Islands,ISV,0,0,0,0,0,1,1,108188.0
1048,2012,London,Great Britain,Uganda,UGA,0,0,0,0,1,1,2,34558700.0
1049,2012,London,Great Britain,Ukraine,UKR,32,24,28,84,83,65,148,45593342.0
1050,2012,London,Great Britain,United Arab Emirates,UAE,1,1,1,3,11,4,15,9141598.0
1051,2012,London,Great Britain,United States of America,USA,31,29,38,98,128,93,221,313877662.0
1052,2012,London,Great Britain,Uruguay,URU,0,0,0,0,1,0,1,3378975.0
1053,2012,London,Great Britain,Uzbekistan,UZB,0,1,0,1,8,2,10,29774500.0
1054,2012,London,Great Britain,Vanuatu,VAN,0,0,0,0,1,0,1,249505.0
1055,2012,London,Great Britain,Venezuela,VEN,0,0,2,2,21,6,27,29360827.0
1056,2012,London,Great Britain,Vietnam,VIE,0,0,0,0,6,5,11,89801926.0
1057,2012,London,Great Britain,Zambia,ZAM,0,0,0,0,1,1,2,14465148.0
1058,2012,London,Great Britain,Zimbabwe,ZIM,0,0,0,0,2,0,2,13115149.0
1059,2016,Rio de Janeiro,Brazil,Afghanistan,AFG,0,0,0,0,1,0,1,35383028.0
1060,2016,Rio de Janeiro,Brazil,Algeria,ALG,4,5,7,16,34,26,60,40551398.0
1061,2016,Rio de Janeiro,Brazil,Angola,ANG,0,0,0,0,2,2,4,28842482.0
1062,2016,Rio de Janeiro,Brazil,Argentina,ARG,1,1,3,5,56,26,82,43590368.0
1063,2016,Rio de Janeiro,Brazil,Armenia,ARM,0,0,0,0,0,2,2,2936147.0
1064,2016,Rio de Janeiro,Brazil,Aruba,ARU,0,0,0,0,1,0,1,104865.0
1065,2016,Rio de Janeiro,Brazil,Australia,AUS,22,30,29,81,101,69,170,24190907.0
1066,2016,Rio de Janeiro,Brazil,Austria,AUT,1,4,4,9,21,6,27,8736668.0
1067,2016,Rio de Janeiro,Brazil,Azerbaijan,AZE,1,8,2,11,18,5,23,9757812.0
1068,2016,Rio de Janeiro,Brazil,Bahrain,BRN,1,0,0,1,0,2,2,1425793.0
1069,2016,Rio de Janeiro,Brazil,Belarus,BLR,8,0,2,10,10,10,20,9501534.0
1070,2016,Rio de Janeiro,Brazil,Belgium,BEL,5,3,3,11,19,10,29,11331422.0
1071,2016,Rio de Janeiro,Brazil,Benin,BEN,0,0,0,0,1,0,1,10872072.0
1072,2016,Rio de Janeiro,Brazil,Bermuda,BER,0,0,0,0,0,2,2,64554.0
1073,2016,Rio de Janeiro,Brazil,Bosnia and Herzegovina,BIH,0,1,0,1,13,1,14,3386263.0
1074,2016,Rio de Janeiro,Brazil,Botswana,BOT,0,0,0,0,1,0,1,2159925.0
1075,2016,Rio de Janeiro,Brazil,Brazil,BRA,14,29,29,72,184,102,286,206163056.0
1076,2016,Rio de Janeiro,Brazil,Bulgaria,BUL,1,0,0,1,4,3,7,7127822.0
1077,2016,Rio de Janeiro,Brazil,Burkina Faso,BUR,0,0,0,0,1,0,1,18646350.0
1078,2016,Rio de Janeiro,Brazil,Burundi,BDI,0,0,0,0,1,0,1,10488002.0
1079,2016,Rio de Janeiro,Brazil,Cambodia,CAM,0,0,0,0,1,0,1,15766290.0
1080,2016,Rio de Janeiro,Brazil,Cameroon,CMR,0,0,0,0,1,0,1,23926549.0
1081,2016,Rio de Janeiro,Brazil,Canada,CAN,8,10,11,29,80,73,153,36109487.0
1082,2016,Rio de Janeiro,Brazil,Cape Verde,CPV,0,0,1,1,2,0,2,531140.0
1083,2016,Rio de Janeiro,Brazil,Central African Republic,CAF,0,0,0,0,1,0,1,4537683.0
1084,2016,Rio de Janeiro,Brazil,Chile,CHI,0,0,0,0,7,8,15,18209072.0
1085,2016,Rio de Janeiro,Brazil,People's Republic of China,CHN,107,81,51,239,161,146,307,1378665000.0
1086,2016,Rio de Janeiro,Brazil,Chinese Taipei,TPE,0,1,1,2,5,8,13,
1087,2016,Rio de Janeiro,Brazil,Colombia,COL,2,5,10,17,26,13,39,48175048.0
1088,2016,Rio de Janeiro,Brazil,Congo,CGO,0,0,0,0,1,0,1,4980996.0
1089,2016,Rio de Janeiro,Brazil,Costa Rica,CRC,0,0,0,0,2,1,3,4899336.0
1090,2016,Rio de Janeiro,Brazil,Côte d'Ivoire,CIV,0,1,0,1,3,2,5,
1091,2016,Rio de Janeiro,Brazil,Croatia,CRO,2,2,1,5,12,7,19,4174349.0
1092,2016,Rio de Janeiro,Brazil,Cuba,CUB,8,1,6,15,16,6,22,11335108.0
1093,2016,Rio de Janeiro,Brazil,Cyprus,CYP,0,0,0,0,1,1,2,1170189.0
1094,2016,Rio de Janeiro,Brazil,Czech Republic,CZE,1,2,4,7,23,14,37,10566332.0
1095,2016,Rio de Janeiro,Brazil,Denmark,DEN,1,2,4,7,13,8,21,5728010.0
1096,2016,Rio de Janeiro,Brazil,Dominican Republic,DOM,0,0,0,0,2,0,2,10397738.0
1097,2016,Rio de Janeiro,Brazil,DR Congo,COD,0,0,0,0,1,1,2,
1098,2016,Rio de Janeiro,Brazil,Ecuador,ECU,0,0,0,0,4,1,5,16491116.0
1099,2016,Rio de Janeiro,Brazil,Egypt,EGY,3,5,4,12,34,11,45,94447071.0
1100,2016,Rio de Janeiro,Brazil,El Salvador,ESA,0,0,0,0,1,0,1,6356137.0
1101,2016,Rio de Janeiro,Brazil,Estonia,EST,0,0,0,0,2,4,6,1315790.0
1102,2016,Rio de Janeiro,Brazil,Ethiopia,ETH,0,1,0,1,4,1,5,103603461.0
1103,2016,Rio de Janeiro,Brazil,Faroe Islands,FRO,0,0,0,0,0,1,1,48173.0
1104,2016,Rio de Janeiro,Brazil,Fiji,FIJ,0,0,0,0,1,1,2,872406.0
1105,2016,Rio de Janeiro,Brazil,Finland,FIN,1,1,1,3,19,7,26,5495303.0
1106,2016,Rio de Janeiro,Brazil,France,FRA,9,5,14,28,80,42,122,66724104.0
1107,2016,Rio de Janeiro,Brazil,Gabon,GAB,0,0,0,0,1,0,1,2007882.0
1108,2016,Rio de Janeiro,Brazil,Gambia,GAM,0,0,0,0,1,0,1,2149134.0
1109,2016,Rio de Janeiro,Brazil,Georgia,GEO,1,0,0,1,3,2,5,3727505.0
1110,2016,Rio de Janeiro,Brazil,Germany,GER,18,25,14,57,89,66,155,82348669.0
1111,2016,Rio de Janeiro,Brazil,Ghana,GHA,0,0,0,0,3,0,3,28481947.0
1112,2016,Rio de Janeiro,Brazil,Great Britain,GBR,64,39,44,147,151,100,251,65611593.0
1113,2016,Rio de Janeiro,Brazil,Greece,GRE,5,4,4,13,44,16,60,10775971.0
1114,2016,Rio de Janeiro,Brazil,Guatemala,GUA,0,0,0,0,1,0,1,15827690.0
1115,2016,Rio de Janeiro,Brazil,Guinea,GUY,0,0,0,0,1,0,1,11738434.0
1116,2016,Rio de Janeiro,Brazil,Guinea-Bissau,GBS,0,0,0,0,1,0,1,1782434.0
1117,2016,Rio de Janeiro,Brazil,Haiti,HAI,0,0,0,0,1,0,1,10839976.0
1118,2016,Rio de Janeiro,Brazil,Honduras,HON,0,0,0,0,2,0,2,9270794.0
1119,2016,Rio de Janeiro,Brazil,"Hong Kong, China",HKG,2,2,2,6,9,15,24,7336600.0
1120,2016,Rio de Janeiro,Brazil,Hungary,HUN,1,8,9,18,19,24,43,9814023.0
1121,2016,Rio de Janeiro,Brazil,Iceland,ISL,0,0,0,0,3,2,5,335439.0
1122,2016,Rio de Janeiro,Brazil,India,IND,2,1,1,4,16,3,19,1324517250.0
1123,2016,Rio de Janeiro,Brazil,Individual Paralympic Athletes,IPA,0,0,0,0,2,0,2,
1124,2016,Rio de Janeiro,Brazil,Indonesia,INA,0,0,1,1,6,3,9,261556386.0
1125,2016,Rio de Janeiro,Brazil,Islamic Republic of Iran,IRI,8,9,7,24,85,23,108,79563991.0
1126,2016,Rio de Janeiro,Brazil,Iraq,IRQ,2,3,0,5,12,2,14,36610632.0
1127,2016,Rio de Janeiro,Brazil,Ireland,IRL,4,4,3,11,30,14,44,4755335.0
1128,2016,Rio de Janeiro,Brazil,Israel,ISR,0,0,3,3,17,16,33,8546000.0
1129,2016,Rio de Janeiro,Brazil,Italy,ITA,10,14,15,39,60,40,100,60627498.0
1130,2016,Rio de Janeiro,Brazil,Jamaica,JAM,0,0,0,0,2,1,3,2906242.0
1131,2016,Rio de Janeiro,Brazil,Japan,JPN,0,10,14,24,86,46,132,126994511.0
1132,2016,Rio de Janeiro,Brazil,Jordan,JOR,0,2,1,3,7,3,10,9554286.0
1133,2016,Rio de Janeiro,Brazil,Kazakhstan,KAZ,1,1,0,2,7,4,11,17794055.0
1134,2016,Rio de Janeiro,Brazil,Kenya,KEN,3,1,2,6,7,2,9,49051531.0
1135,2016,Rio de Janeiro,Brazil,Republic of Korea,KOR,7,11,17,35,53,29,82,51217803.0
1136,2016,Rio de Janeiro,Brazil,Korea DPR,PRK,0,0,0,0,1,1,2,
1137,2016,Rio de Janeiro,Brazil,Kuwait,KUW,1,0,0,1,6,0,6,3956862.0
1138,2016,Rio de Janeiro,Brazil,Kyrgyzstan,KGZ,0,0,0,0,3,0,3,6079500.0
1139,2016,Rio de Janeiro,Brazil,Lao People's Democratic Republic,LAO,0,0,0,0,1,0,1,6845848.0
1140,2016,Rio de Janeiro,Brazil,Latvia,LAT,2,0,2,4,6,5,11,1959537.0
1141,2016,Rio de Janeiro,Brazil,Lesotho,LES,0,0,0,0,1,1,2,2075041.0
1142,2016,Rio de Janeiro,Brazil,Libya,LBA,0,0,0,0,1,2,3,6492160.0
1143,2016,Rio de Janeiro,Brazil,Lithuania,LTU,2,1,0,3,12,1,13,2868231.0
1144,2016,Rio de Janeiro,Brazil,Luxembourg,LUX,0,0,0,0,3,0,3,582014.0
1145,2016,Rio de Janeiro,Brazil,"Macao, China",MAC,0,0,0,0,1,0,1,
1146,2016,Rio de Janeiro,Brazil,Madagascar,MAD,0,0,0,0,1,0,1,24894370.0
1147,2016,Rio de Janeiro,Brazil,Malawi,MAW,0,0,0,0,0,1,1,17205253.0
1148,2016,Rio de Janeiro,Brazil,Malaysia,MAS,3,0,1,4,17,2,19,30684652.0
1149,2016,Rio de Janeiro,Brazil,Mali,MLI,0,0,0,0,1,1,2,17965448.0
1150,2016,Rio de Janeiro,Brazil,Malta,MLT,0,0,0,0,0,1,1,455356.0
1151,2016,Rio de Janeiro,Brazil,Mauritius,MRI,0,0,0,0,1,1,2,1263473.0
1152,2016,Rio de Janeiro,Brazil,Mexico,MEX,4,2,9,15,37,32,69,123333379.0
1153,2016,Rio de Janeiro,Brazil,Republic of Moldova,MDA,0,0,0,0,1,2,3,2802170.0
1154,2016,Rio de Janeiro,Brazil,Mongolia,MGL,0,0,2,2,6,2,8,3056358.0
1155,2016,Rio de Janeiro,Brazil,Montenegro,MNE,0,0,0,0,1,1,2,622303.0
1156,2016,Rio de Janeiro,Brazil,Morocco,MAR,3,2,2,7,18,6,24,35126274.0
1157,2016,Rio de Janeiro,Brazil,Mozambique,MOZ,0,0,1,1,0,1,1,27829930.0
1158,2016,Rio de Janeiro,Brazil,Myanmar,MYA,0,0,0,0,2,0,2,53045199.0
1159,2016,Rio de Janeiro,Brazil,Namibia,NAM,1,2,2,5,7,2,9,2358044.0
1160,2016,Rio de Janeiro,Brazil,Nepal,NEP,0,0,0,0,1,1,2,27263430.0
1161,2016,Rio de Janeiro,Brazil,Netherlands,NED,17,19,26,62,58,62,120,17030314.0
1162,2016,Rio de Janeiro,Brazil,New Zealand,NZL,9,5,7,21,17,12,29,4714100.0
1163,2016,Rio de Janeiro,Brazil,Nicaragua,NCA,0,0,0,0,2,1,3,6303970.0
1164,2016,Rio de Janeiro,Brazil,Niger,NIG,0,0,0,0,1,1,2,20788789.0
1165,2016,Rio de Janeiro,Brazil,Nigeria,NGR,8,2,2,12,9,13,22,185960244.0
1166,2016,Rio de Janeiro,Brazil,North Macedonia,MKD,0,0,0,0,1,1,2,2080746.0
1167,2016,Rio de Janeiro,Brazil,Norway,NOR,3,2,3,8,12,13,25,5234519.0
1168,2016,Rio de Janeiro,Brazil,Oman,OMA,0,0,0,0,1,1,2,4479217.0
1169,2016,Rio de Janeiro,Brazil,Pakistan,PAK,0,0,1,1,1,0,1,203631356.0
1170,2016,Rio de Janeiro,Brazil,Palestine,PLE,0,0,0,0,1,0,1,
1171,2016,Rio de Janeiro,Brazil,Panama,PAN,0,0,0,0,1,1,2,4037073.0
1172,2016,Rio de Janeiro,Brazil,Papua New Guinea,PNG,0,0,0,0,1,1,2,8271766.0
1173,2016,Rio de Janeiro,Brazil,Peru,PER,0,0,0,0,5,1,6,30926036.0
1174,2016,Rio de Janeiro,Brazil,Philippines,PHI,0,0,1,1,3,2,5,103663812.0
1175,2016,Rio de Janeiro,Brazil,Poland,POL,9,18,12,39,54,36,90,37970087.0
1176,2016,Rio de Janeiro,Brazil,Portugal,POR,0,0,4,4,25,12,37,10325452.0
1177,2016,Rio de Janeiro,Brazil,Puerto Rico,PUR,0,0,0,0,3,1,4,3406672.0
1178,2016,Rio de Janeiro,Brazil,Qatar,QAT,0,2,0,2,2,1,3,2654379.0
1179,2016,Rio de Janeiro,Brazil,Romania,ROU,0,0,1,1,9,3,12,19702267.0
1180,2016,Rio de Janeiro,Brazil,Rwanda,RWA,0,0,0,0,1,12,13,11668829.0
1181,2016,Rio de Janeiro,Brazil,Samoa,SAM,0,0,0,0,1,1,2,194540.0
1182,2016,Rio de Janeiro,Brazil,Sao Tome and Principe,STP,0,0,0,0,1,0,1,203221.0
1183,2016,Rio de Janeiro,Brazil,Saudi Arabia,KSA,0,0,1,1,3,0,3,32443443.0
1184,2016,Rio de Janeiro,Brazil,Senegal,SEN,0,0,0,0,1,1,2,14993514.0
1185,2016,Rio de Janeiro,Brazil,Serbia,SRB,3,2,4,9,13,3,16,7058322.0
1186,2016,Rio de Janeiro,Brazil,Seychelles,SEY,0,0,0,0,1,0,1,94677.0
1187,2016,Rio de Janeiro,Brazil,Sierra Leone,SLE,0,0,0,0,1,0,1,7328846.0
1188,2016,Rio de Janeiro,Brazil,Singapore,SGP,2,0,1,3,4,9,13,5607283.0
1189,2016,Rio de Janeiro,Brazil,Slovakia,SVK,5,3,3,11,21,7,28,5430798.0
1190,2016,Rio de Janeiro,Brazil,Slovenia,SLO,1,1,0,2,7,1,8,2065042.0
1191,2016,Rio de Janeiro,Brazil,Somalia,SOM,0,0,0,0,1,0,1,14185635.0
1192,2016,Rio de Janeiro,Brazil,South Africa,RSA,7,6,4,17,26,18,44,56207649.0
1193,2016,Rio de Janeiro,Brazil,Spain,ESP,9,14,8,31,83,28,111,46484062.0
1194,2016,Rio de Janeiro,Brazil,Sri Lanka,SRI,0,0,1,1,8,1,9,21203000.0
1195,2016,Rio de Janeiro,Brazil,Suriname,SUR,0,0,0,0,1,0,1,564883.0
1196,2016,Rio de Janeiro,Brazil,Sweden,SWE,1,4,5,10,39,18,57,9923085.0
1197,2016,Rio de Janeiro,Brazil,Switzerland,SUI,2,2,1,5,14,10,24,8373338.0
1198,2016,Rio de Janeiro,Brazil,Syrian Arab Republic,SYR,0,0,0,0,1,1,2,17465567.0
1199,2016,Rio de Janeiro,Brazil,Tajikistan,TJK,0,0,0,0,1,0,1,8663575.0
1200,2016,Rio de Janeiro,Brazil,Tanzania,TAN,0,0,0,0,1,0,1,
1201,2016,Rio de Janeiro,Brazil,Thailand,THA,6,6,6,18,30,15,45,68971313.0
1202,2016,Rio de Janeiro,Brazil,Timor-Leste,TLS,0,0,0,0,1,1,2,1219289.0
1203,2016,Rio de Janeiro,Brazil,Togo,TOG,0,0,0,0,1,0,1,7509952.0
1204,2016,Rio de Janeiro,Brazil,Tonga,TGA,0,0,0,0,1,1,2,101143.0
1205,2016,Rio de Janeiro,Brazil,Trinidad and Tobago,TTO,1,1,1,3,1,2,3,1377563.0
1206,2016,Rio de Janeiro,Brazil,Tunisia,TUN,7,6,6,19,14,17,31,11303942.0
1207,2016,Rio de Janeiro,Brazil,Turkey,TUR,3,1,5,9,46,32,78,79827868.0
1208,2016,Rio de Janeiro,Brazil,Turkmenistan,TKM,0,0,0,0,1,1,2,5662371.0
1209,2016,Rio de Janeiro,Brazil,US Virgin Islands,ISV,0,0,0,0,1,0,1,107516.0
1210,2016,Rio de Janeiro,Brazil,Uganda,UGA,0,1,0,1,1,0,1,39649173.0
1211,2016,Rio de Janeiro,Brazil,Ukraine,UKR,41,37,39,117,91,77,168,45004673.0
1212,2016,Rio de Janeiro,Brazil,United Arab Emirates,UAE,2,4,1,7,12,6,18,9360975.0
1213,2016,Rio de Janeiro,Brazil,United States of America,USA,40,44,31,115,154,124,278,323071755.0
1214,2016,Rio de Janeiro,Brazil,Uruguay,URU,0,0,0,0,3,1,4,3424139.0
1215,2016,Rio de Janeiro,Brazil,Uzbekistan,UZB,8,6,17,31,22,10,32,31847900.0
1216,2016,Rio de Janeiro,Brazil,Venezuela,VEN,0,3,3,6,16,8,24,29851249.0
1217,2016,Rio de Janeiro,Brazil,Vietnam,VIE,1,1,2,4,7,4,11,93640435.0
1218,2016,Rio de Janeiro,Brazil,Zimbabwe,ZIM,0,0,0,0,2,3,5,14030338.0
1219,2020,Tokyo,Japan,Afghanistan,AFG,0,0,0,0,1,1,2,38928341.0
1220,2020,Tokyo,Japan,Algeria,ALG,4,4,4,12,35,21,56,43851043.0
1221,2020,Tokyo,Japan,Angola,ANG,0,0,0,0,1,1,2,32866268.0
1222,2020,Tokyo,Japan,Argentina,ARG,0,5,4,9,40,19,59,45376763.0
1223,2020,Tokyo,Japan,Armenia,ARM,0,0,0,0,1,0,1,2963234.0
1224,2020,Tokyo,Japan,Aruba,ARU,0,0,0,0,1,0,1,106766.0
1225,2020,Tokyo,Japan,Australia,AUS,21,29,30,80,101,80,181,25687041.0
1226,2020,Tokyo,Japan,Austria,AUT,1,5,3,9,18,7,25,8917205.0
1227,2020,Tokyo,Japan,Azerbaijan,AZE,14,1,4,19,24,12,36,10110116.0
1228,2020,Tokyo,Japan,Bahrain,BRN,0,0,0,0,1,1,2,1701583.0
1229,2020,Tokyo,Japan,Barbados,BAR,0,0,0,0,1,0,1,287371.0
1230,2020,Tokyo,Japan,Belarus,BLR,5,1,1,7,12,7,19,9398861.0
1231,2020,Tokyo,Japan,Belgium,BEL,4,3,8,15,25,9,34,11555997.0
1232,2020,Tokyo,Japan,Benin,BEN,0,0,0,0,1,1,2,12123198.0
1233,2020,Tokyo,Japan,Bermuda,BER,0,0,0,0,0,1,1,63903.0
1234,2020,Tokyo,Japan,Bhutan,BHU,0,0,0,0,2,1,3,771612.0
1235,2020,Tokyo,Japan,Bosnia and Herzegovina,BIH,0,0,1,1,14,1,15,3280815.0
1236,2020,Tokyo,Japan,Botswana,BOT,0,0,0,0,1,1,2,2351625.0
1237,2020,Tokyo,Japan,Brazil,BRA,22,20,30,72,145,96,241,212559409.0
1238,2020,Tokyo,Japan,Bulgaria,BUL,0,2,0,2,2,2,4,6927288.0
1239,2020,Tokyo,Japan,Burkina Faso,BUR,0,0,0,0,1,1,2,20903278.0
1240,2020,Tokyo,Japan,Burundi,BDI,0,0,0,0,1,1,2,11890781.0
1241,2020,Tokyo,Japan,Cambodia,CAM,0,0,0,0,1,0,1,16718971.0
1242,2020,Tokyo,Japan,Cameroon,CMR,0,0,0,0,1,2,3,26545864.0
1243,2020,Tokyo,Japan,Canada,CAN,5,10,6,21,57,72,129,38005238.0
1244,2020,Tokyo,Japan,Cape Verde,CPV,0,0,0,0,1,1,2,555988.0
1245,2020,Tokyo,Japan,Central African Republic,CAF,0,0,0,0,0,1,1,4829764.0
1246,2020,Tokyo,Japan,Chile,CHI,2,3,1,6,10,9,19,19116209.0
1247,2020,Tokyo,Japan,Chinese Taipei,TPE,0,0,1,1,4,6,10,
1248,2020,Tokyo,Japan,Colombia,COL,3,7,14,24,44,22,66,50882884.0
1249,2020,Tokyo,Japan,Congo,CGO,0,0,0,0,1,1,2,5518092.0
1250,2020,Tokyo,Japan,Costa Rica,CRC,1,1,0,2,7,2,9,5094114.0
1251,2020,Tokyo,Japan,Côte d'Ivoire,CIV,0,0,0,0,2,1,3,
1252,2020,Tokyo,Japan,Croatia,CRO,0,3,4,7,16,6,22,4047200.0
1253,2020,Tokyo,Japan,Cuba,CUB,4,1,1,6,13,4,17,11326616.0
1254,2020,Tokyo,Japan,Cyprus,CYP,1,0,1,2,1,2,3,1207361.0
1255,2020,Tokyo,Japan,Czech Republic,CZE,2,3,3,8,19,10,29,10698896.0
1256,2020,Tokyo,Japan,Democratic Republic of the Congo,COD,0,0,0,0,1,1,2,89561404.0
1257,2020,Tokyo,Japan,Denmark,DEN,3,1,1,5,16,9,25,5831404.0
1258,2020,Tokyo,Japan,Dominican Republic,DOM,0,0,0,0,3,2,5,10847904.0
1259,2020,Tokyo,Japan,Ecuador,ECU,1,0,2,3,5,3,8,17643060.0
1260,2020,Tokyo,Japan,Egypt,EGY,0,5,2,7,29,20,49,102334403.0
1261,2020,Tokyo,Japan,El Salvador,ESA,0,0,1,1,2,1,3,6486201.0
1262,2020,Tokyo,Japan,Estonia,EST,0,0,0,0,4,1,5,1331057.0
1263,2020,Tokyo,Japan,Ethiopia,ETH,1,0,0,1,2,1,3,114963583.0
1264,2020,Tokyo,Japan,Faroe Islands,FRO,0,0,0,0,1,0,1,48865.0
1265,2020,Tokyo,Japan,Fiji,FIJ,0,0,0,0,2,0,2,896444.0
1266,2020,Tokyo,Japan,Finland,FIN,1,3,1,5,11,5,16,5530719.0
1267,2020,Tokyo,Japan,France,FRA,11,15,28,54,108,38,146,67391582.0
1268,2020,Tokyo,Japan,Gabon,GAB,0,0,0,0,1,1,2,2225728.0
1269,2020,Tokyo,Japan,Gambia,GAM,0,0,0,0,1,1,2,2416664.0
1270,2020,Tokyo,Japan,Georgia,GEO,0,3,0,3,9,4,13,3714000.0
1271,2020,Tokyo,Japan,Germany,GER,13,12,18,43,79,58,137,83240525.0
1272,2020,Tokyo,Japan,Ghana,GHA,0,0,0,0,3,0,3,31072945.0
1273,2020,Tokyo,Japan,Great Britain,GBR,41,38,45,124,124,97,221,67215293.0
1274,2020,Tokyo,Japan,Greece,GRE,1,3,7,11,34,11,45,10715549.0
1275,2020,Tokyo,Japan,Grenada,GRN,0,0,0,0,0,2,2,112519.0
1276,2020,Tokyo,Japan,Guatemala,GUA,0,0,0,0,1,1,2,16858333.0
1277,2020,Tokyo,Japan,Guinea,GUI,0,0,0,0,1,1,2,13132792.0
1278,2020,Tokyo,Japan,Guinea-Bissau,GBS,0,0,0,0,1,0,1,1967998.0
1279,2020,Tokyo,Japan,Guyana,GUY,0,0,0,0,1,0,1,786559.0
1280,2020,Tokyo,Japan,Haiti,HAI,0,0,0,0,1,0,1,11402533.0
1281,2020,Tokyo,Japan,Honduras,HON,0,0,0,0,1,0,1,9904608.0
1282,2020,Tokyo,Japan,"Hong Kong, China",HKG,0,2,3,5,9,14,23,7481800.0
1283,2020,Tokyo,Japan,Hungary,HUN,7,5,4,16,19,20,39,9749763.0
1284,2020,Tokyo,Japan,Iceland,ISL,0,0,0,0,3,3,6,366425.0
1285,2020,Tokyo,Japan,India,IND,5,8,6,19,40,14,54,1380004385.0
1286,2020,Tokyo,Japan,Indonesia,INA,2,3,4,9,14,9,23,273523621.0
1287,2020,Tokyo,Japan,Iraq,IRQ,0,1,2,3,14,5,19,40222503.0
1288,2020,Tokyo,Japan,Ireland,IRL,4,2,1,7,15,16,31,4994724.0
1289,2020,Tokyo,Japan,Islamic Republic of Iran,IRI,12,11,1,24,54,9,63,83992953.0
1290,2020,Tokyo,Japan,Israel,ISR,6,2,1,9,15,18,33,9216900.0
1291,2020,Tokyo,Japan,Italy,ITA,14,29,26,69,52,62,114,59554023.0
1292,2020,Tokyo,Japan,Jamaica,JAM,0,0,0,0,2,2,4,2961161.0
1293,2020,Tokyo,Japan,Japan,JPN,13,15,23,51,153,109,262,125836021.0
1294,2020,Tokyo,Japan,Jordan,JOR,4,0,1,5,6,4,10,10203140.0
1295,2020,Tokyo,Japan,Kazakhstan,KAZ,1,3,1,5,16,10,26,18754440.0
1296,2020,Tokyo,Japan,Kenya,KEN,0,0,1,1,4,5,9,53771300.0
1297,2020,Tokyo,Japan,Kuwait,KUW,0,1,1,2,2,1,3,4270563.0
1298,2020,Tokyo,Japan,Kyrgyzstan,KGZ,0,0,0,0,1,1,2,6591600.0
1299,2020,Tokyo,Japan,Lao People's Democratic Republic,LAO,0,0,0,0,1,0,1,7275556.0
1300,2020,Tokyo,Japan,Latvia,LAT,0,3,2,5,4,3,7,1901548.0
1301,2020,Tokyo,Japan,Lebanon,LBN,0,0,0,0,1,0,1,6825442.0
1302,2020,Tokyo,Japan,Lesotho,LES,0,0,0,0,0,1,1,2142252.0
1303,2020,Tokyo,Japan,Liberia,LBR,0,0,0,0,1,1,2,5057677.0
1304,2020,Tokyo,Japan,Libya,LBA,0,0,0,0,2,0,2,6871287.0
1305,2020,Tokyo,Japan,Lithuania,LTU,0,0,3,3,10,1,11,2794700.0
1306,2020,Tokyo,Japan,Luxembourg,LUX,0,0,0,0,1,0,1,632275.0
1307,2020,Tokyo,Japan,Madagascar,MAD,0,0,0,0,0,1,1,27691019.0
1308,2020,Tokyo,Japan,Malawi,MAW,0,0,0,0,0,1,1,19129955.0
1309,2020,Tokyo,Japan,Malaysia,MAS,3,2,0,5,21,4,25,32365998.0
1310,2020,Tokyo,Japan,Maldives,MDV,0,0,0,0,1,1,2,540542.0
1311,2020,Tokyo,Japan,Mali,MLI,0,0,0,0,1,1,2,20250834.0
1312,2020,Tokyo,Japan,Malta,MLT,0,0,0,0,1,1,2,525285.0
1313,2020,Tokyo,Japan,Mauritius,MRI,0,0,0,0,1,3,4,1265740.0
1314,2020,Tokyo,Japan,Mexico,MEX,7,2,13,22,31,29,60,128932753.0
1315,2020,Tokyo,Japan,Mongolia,MGL,1,0,0,1,7,4,11,3278292.0
1316,2020,Tokyo,Japan,Montenegro,MNE,0,0,1,1,4,1,5,621718.0
1317,2020,Tokyo,Japan,Morocco,MAR,4,4,3,11,23,13,36,36910558.0
1318,2020,Tokyo,Japan,Mozambique,MOZ,0,0,0,0,1,1,2,31255435.0
1319,2020,Tokyo,Japan,Namibia,NAM,0,1,1,2,2,1,3,2540916.0
1320,2020,Tokyo,Japan,Nepal,NEP,0,0,0,0,0,1,1,29136808.0
1321,2020,Tokyo,Japan,Netherlands,NED,25,17,17,59,33,41,74,17441139.0
1322,2020,Tokyo,Japan,New Zealand,NZL,6,3,3,12,16,16,32,5084300.0
1323,2020,Tokyo,Japan,Nicaragua,NCA,0,0,0,0,1,1,2,6624554.0
1324,2020,Tokyo,Japan,Niger,NIG,0,0,0,0,1,1,2,24206636.0
1325,2020,Tokyo,Japan,Nigeria,NGR,4,1,5,10,10,12,22,206139587.0
1326,2020,Tokyo,Japan,North Macedonia,MKD,0,0,0,0,0,1,1,2083380.0
1327,2020,Tokyo,Japan,Norway,NOR,2,0,2,4,5,10,15,5379475.0
1328,2020,Tokyo,Japan,Oman,OMA,0,0,1,1,2,1,3,5106622.0
1329,2020,Tokyo,Japan,Pakistan,PAK,1,0,0,1,1,1,2,220892331.0
1330,2020,Tokyo,Japan,Palestine,PLE,0,0,0,0,1,0,1,
1331,2020,Tokyo,Japan,Panama,PAN,0,0,0,0,2,1,3,4314768.0
1332,2020,Tokyo,Japan,Papua New Guinea,PNG,0,0,0,0,1,1,2,8947027.0
1333,2020,Tokyo,Japan,Paraguay,PAR,0,0,0,0,1,1,2,7132530.0
1334,2020,Tokyo,Japan,People's Republic of China,CHN,96,60,51,207,120,136,256,1402112000.0
1335,2020,Tokyo,Japan,Peru,PER,1,0,0,1,7,4,11,32971846.0
1336,2020,Tokyo,Japan,Philippines,PHI,0,0,0,0,4,0,4,109581085.0
1337,2020,Tokyo,Japan,Poland,POL,7,6,12,25,55,36,91,37950802.0
1338,2020,Tokyo,Japan,Portugal,POR,0,0,2,2,24,10,34,10305564.0
1339,2020,Tokyo,Japan,Puerto Rico,PUR,0,0,0,0,2,1,3,3194034.0
1340,2020,Tokyo,Japan,Qatar,QAT,0,0,1,1,1,1,2,2881060.0
1341,2020,Tokyo,Japan,Refugee Paralympic Team,RPT,0,0,0,0,5,1,6,
1342,2020,Tokyo,Japan,Republic of Korea,KOR,2,10,12,24,57,28,85,51780579.0
1343,2020,Tokyo,Japan,Republic of Moldova,MDA,0,0,0,0,4,2,6,2617820.0
1344,2020,Tokyo,Japan,Romania,ROU,0,1,1,2,8,1,9,19286123.0
1345,2020,Tokyo,Japan,RPC,RPC,36,33,49,118,134,114,248,144104080.0
1346,2020,Tokyo,Japan,Rwanda,RWA,0,0,0,0,1,13,14,12952209.0
1347,2020,Tokyo,Japan,Sao Tome and Principe,STP,0,0,0,0,1,0,1,219161.0
1348,2020,Tokyo,Japan,Saudi Arabia,KSA,0,0,1,1,5,2,7,34813867.0
1349,2020,Tokyo,Japan,Senegal,SEN,0,0,0,0,2,1,3,16743930.0
1350,2020,Tokyo,Japan,Serbia,SRB,2,3,1,6,13,7,20,6908224.0
1351,2020,Tokyo,Japan,Sierra Leone,SLE,0,0,0,0,1,1,2,7976985.0
1352,2020,Tokyo,Japan,Singapore,SGP,2,0,0,2,5,6,11,5685807.0
1353,2020,Tokyo,Japan,Slovakia,SVK,5,2,4,11,21,7,28,5458827.0
1354,2020,Tokyo,Japan,Slovenia,SLO,0,1,1,2,7,0,7,2100126.0
1355,2020,Tokyo,Japan,Somalia,SOM,0,0,0,0,1,0,1,15893219.0
1356,2020,Tokyo,Japan,South Africa,RSA,4,1,2,7,20,14,34,59308690.0
1357,2020,Tokyo,Japan,Spain,ESP,9,15,12,36,93,44,137,47351567.0
1358,2020,Tokyo,Japan,Sri Lanka,SRI,1,0,1,2,8,1,9,21919000.0
1359,2020,Tokyo,Japan,St Vincent and the Grenadines,VIN,0,0,0,0,1,0,1,110947.0
1360,2020,Tokyo,Japan,Sweden,SWE,1,5,2,8,12,17,29,10353442.0
1361,2020,Tokyo,Japan,Switzerland,SUI,7,4,3,14,8,13,21,8636896.0
1362,2020,Tokyo,Japan,Syrian Arab Republic,SYR,0,0,0,0,1,2,3,17500657.0
1363,2020,Tokyo,Japan,Tajikistan,TJK,0,0,0,0,1,0,1,9537642.0
1364,2020,Tokyo,Japan,Thailand,THA,5,5,8,18,50,26,76,69799978.0
1365,2020,Tokyo,Japan,Togo,TOG,0,0,0,0,0,1,1,8278737.0
1366,2020,Tokyo,Japan,Tunisia,TUN,4,5,2,11,12,13,25,11818618.0
1367,2020,Tokyo,Japan,Turkey,TUR,2,4,9,15,43,44,87,84339067.0
1368,2020,Tokyo,Japan,Uganda,UGA,0,0,1,1,1,3,4,45741000.0
1369,2020,Tokyo,Japan,Ukraine,UKR,24,47,27,98,80,59,139,44134693.0
1370,2020,Tokyo,Japan,United Arab Emirates,UAE,1,1,1,3,7,5,12,9890400.0
1371,2020,Tokyo,Japan,United Republic of Tanzania,TAN,0,0,0,0,1,1,2,59734213.0
1372,2020,Tokyo,Japan,United States of America,USA,37,36,31,104,120,123,243,329484123.0
1373,2020,Tokyo,Japan,Uruguay,URU,0,0,0,0,1,1,2,3473727.0
1374,2020,Tokyo,Japan,Uzbekistan,UZB,8,5,6,19,25,19,44,34232050.0
1375,2020,Tokyo,Japan,Venezuela,VEN,3,2,2,7,13,14,27,28435943.0
1376,2020,Tokyo,Japan,Vietnam,VIE,0,1,0,1,4,3,7,97338583.0
1377,2020,Tokyo,Japan,US Virgin Islands,ISV,0,0,0,0,0,1,1,106290.0
1378,2020,Tokyo,Japan,Yemen,YEM,0,0,0,0,1,1,2,29825968.0
1379,2020,Tokyo,Japan,Zambia,ZAM,0,0,0,0,0,1,1,18383956.0
1380,2020,Tokyo,Japan,Zimbabwe,ZIM,0,0,0,0,0,2,2,14862927.0
