Year,Host_City,Host_Country,Country,Country_Code,Gold,Silver,Bronze,M_Total,Men,Women,P_Total,Population
1960,Rome,Italy,Argentina,ARG,2,3,1,6,5,4,9,20481781
1960,Rome,Italy,Australia,AUS,3,6,1,10,10,1,11,10276477
1960,Rome,Italy,Austria,AUT,11,8,11,30,12,7,19,7047539
1960,Rome,Italy,Belgium,BEL,1,1,1,3,10,2,12,9153489
1960,Rome,Italy,Finland,FIN,1,0,0,1,1,0,1,4429634
1960,Rome,Italy,France,FRA,3,3,1,7,10,1,11,46621688
1960,Rome,Italy,Germany,GER,15,6,9,30,7,2,9,72814900
1960,Rome,Italy,Great Britain,GBR,20,15,20,55,29,13,42,52400000
1960,Rome,Italy,Ireland,IRL,2,0,0,2,0,1,1,2828600
1960,Rome,Italy,Israel,ISR,0,2,2,4,6,1,7,2114020
1960,Rome,Italy,Italy,ITA,29,28,23,80,23,4,27,50199700
1960,Rome,Italy,Malta,MLT,0,2,2,4,5,1,6,326550
1960,Rome,Italy,Netherlands,NED,3,6,0,9,11,2,13,11486631
1960,Rome,Italy,Norway,NOR,9,3,4,16,7,4,11,3581239
1960,Rome,Italy,Rhodesia,ZIM,2,1,2,5,0,1,1,
1960,Rome,Italy,Switzerland,SUI,1,3,0,4,5,1,6,5327827
1960,Rome,Italy,United States of America,USA,11,7,7,25,23,0,23,180671000
1964,Tokyo,Japan,Argentina,ARG,6,15,16,37,19,6,25,21824427
1964,Tokyo,Japan,Australia,AUS,12,11,7,30,13,4,17,11167000
1964,Tokyo,Japan,Austria,AUT,4,1,7,12,3,4,7,7223801
1964,Tokyo,Japan,Belgium,BEL,1,0,2,3,1,1,2,9378113
1964,Tokyo,Japan,Fiji,FIJ,0,0,0,0,1,0,1,450538
1964,Tokyo,Japan,France,FRA,4,2,5,11,13,0,13,49230585
1964,Tokyo,Japan,Germany,GER,5,2,5,12,8,1,9,75318337
1964,Tokyo,Japan,Great Britain,GBR,18,23,20,61,30,14,44,54000000
1964,Tokyo,Japan,Ireland,IRL,0,0,0,0,2,0,2,2866550
1964,Tokyo,Japan,Israel,ISR,7,3,11,21,16,3,19,2475000
1964,Tokyo,Japan,Italy,ITA,14,15,16,45,14,5,19,51675350
1964,Tokyo,Japan,Japan,JPN,1,5,4,10,14,2,16,96903000
1964,Tokyo,Japan,Malta,MLT,0,0,2,2,2,0,2,321250
1964,Tokyo,Japan,Netherlands,NED,4,6,4,14,4,3,7,12127120
1964,Tokyo,Japan,Rhodesia,ZIM,10,5,2,17,4,2,6,
1964,Tokyo,Japan,South Africa,RSA,8,8,3,19,5,4,9,18896303
1964,Tokyo,Japan,Sweden,SWE,0,0,1,1,1,0,1,7661354
1964,Tokyo,Japan,Switzerland,SUI,0,1,0,1,0,1,1,5789228
1964,Tokyo,Japan,United States of America,USA,50,41,32,123,45,20,65,191889000
1964,Tokyo,Japan,West Germany,FRG,0,0,0,0,0,1,1,
1968,Tel Aviv,Israel,Argentina,ARG,10,10,10,30,14,7,21,23168268
1968,Tel Aviv,Israel,Australia,AUS,15,16,7,38,23,12,35,12009000
1968,Tel Aviv,Israel,Austria,AUT,2,7,10,19,19,12,31,7415403
1968,Tel Aviv,Israel,Belgium,BEL,0,3,3,6,21,5,26,9618756
1968,Tel Aviv,Israel,Canada,CAN,6,6,7,19,18,7,25,20744000
1968,Tel Aviv,Israel,Denmark,DEN,0,0,0,0,7,1,8,4864883
1968,Tel Aviv,Israel,Ethiopia,ETH,0,0,0,0,2,0,2,26944386
1968,Tel Aviv,Israel,Finland,FIN,0,0,0,0,2,0,2,4626469
1968,Tel Aviv,Israel,France,FRA,13,10,9,32,40,14,54,51175507
1968,Tel Aviv,Israel,Great Britain,GBR,29,20,20,69,50,24,74,55211700
1968,Tel Aviv,Israel,India,IND,0,0,0,0,8,2,10,531513834
1968,Tel Aviv,Israel,Ireland,IRL,0,4,5,9,5,2,7,2915550
1968,Tel Aviv,Israel,Israel,ISR,18,21,23,62,38,16,54,2803000
1968,Tel Aviv,Israel,Italy,ITA,12,10,17,39,33,5,38,53235750
1968,Tel Aviv,Israel,Jamaica,JAM,3,1,1,5,7,4,11,1825873
1968,Tel Aviv,Israel,Japan,JPN,2,2,8,12,40,7,47,101011000
1968,Tel Aviv,Israel,Republic of Korea,KOR,0,0,0,0,5,0,5,30838302
1968,Tel Aviv,Israel,Malta,MLT,0,0,0,0,4,2,6,307900
1968,Tel Aviv,Israel,Netherlands,NED,12,4,4,20,24,11,35,12729721
1968,Tel Aviv,Israel,New Zealand,NZL,1,2,1,4,17,1,18,2748100
1968,Tel Aviv,Israel,Norway,NOR,5,3,1,9,18,9,27,3816486
1968,Tel Aviv,Israel,Rhodesia,ZIM,6,7,7,20,7,7,14,
1968,Tel Aviv,Israel,South Africa,RSA,9,10,7,26,5,3,8,20942147
1968,Tel Aviv,Israel,Spain,ESP,0,3,1,4,9,2,11,33113134
1968,Tel Aviv,Israel,Sweden,SWE,1,6,4,11,27,5,32,7912273
1968,Tel Aviv,Israel,Switzerland,SUI,0,2,6,8,32,2,34,6067714
1968,Tel Aviv,Israel,United States of America,USA,33,27,39,99,53,29,82,200706000
1968,Tel Aviv,Israel,West Germany,FRG,12,12,11,35,50,8,58,
1972,Heidelberg,Germany,Argentina,ARG,2,4,3,9,12,9,21,24653172
1972,Heidelberg,Germany,Australia,AUS,6,9,10,25,28,9,37,13177000
1972,Heidelberg,Germany,Austria,AUT,6,6,6,18,22,10,32,7544201
1972,Heidelberg,Germany,Bahamas,BAH,0,0,0,0,1,0,1,
1972,Heidelberg,Germany,Belgium,BEL,1,1,2,4,18,5,23,9711115
1972,Heidelberg,Germany,Brazil,BRA,0,0,0,0,8,0,8,99859388
1972,Heidelberg,Germany,Canada,CAN,5,6,8,19,27,13,40,22218463
1972,Heidelberg,Germany,Czechoslovakia,TCH,0,0,1,1,14,5,19,
1972,Heidelberg,Germany,Denmark,DEN,0,0,0,0,8,2,10,4991596
1972,Heidelberg,Germany,Egypt,EGY,0,0,0,0,1,0,1,36102670
1972,Heidelberg,Germany,Finland,FIN,0,2,1,3,20,4,24,4639657
1972,Heidelberg,Germany,France,FRA,10,8,15,33,42,19,61,52793151
1972,Heidelberg,Germany,Great Britain,GBR,16,15,21,52,48,25,73,56086065
1972,Heidelberg,Germany,"Hong Kong, China",HKG,0,1,1,2,10,0,10,4123600
1972,Heidelberg,Germany,Hungary,HUN,0,0,1,1,4,1,5,10398489
1972,Heidelberg,Germany,India,IND,1,0,0,1,7,3,10,581087255
1972,Heidelberg,Germany,Ireland,IRL,2,4,2,8,8,9,17,3036850
1972,Heidelberg,Germany,Israel,ISR,9,10,9,28,19,11,30,3148000
1972,Heidelberg,Germany,Italy,ITA,8,4,5,17,20,5,25,54381345
1972,Heidelberg,Germany,Jamaica,JAM,8,3,4,15,13,7,20,1935089
1972,Heidelberg,Germany,Japan,JPN,4,5,3,12,23,5,28,107188000
1972,Heidelberg,Germany,Kenya,KEN,1,0,0,1,4,0,4,12146070
1972,Heidelberg,Germany,Republic of Korea,KOR,4,2,1,7,7,1,8,33505406
1972,Heidelberg,Germany,Malaysia,MAS,0,0,0,0,4,0,4,11324277
1972,Heidelberg,Germany,Malta,MLT,0,0,0,0,5,3,8,302450
1972,Heidelberg,Germany,Mexico,MEX,0,0,0,0,7,0,7,54689944
1972,Heidelberg,Germany,Netherlands,NED,14,13,11,38,26,12,38,13328593
1972,Heidelberg,Germany,New Zealand,NZL,3,3,3,9,7,3,10,2903900
1972,Heidelberg,Germany,Norway,NOR,1,5,4,10,18,9,27,3933004
1972,Heidelberg,Germany,Peru,PER,0,0,0,0,1,0,1,14221954
1972,Heidelberg,Germany,Poland,POL,14,12,7,33,12,10,22,33055650
1972,Heidelberg,Germany,Rhodesia,ZIM,3,5,4,12,6,7,13,
1972,Heidelberg,Germany,Romania,ROU,0,0,0,0,1,0,1,20657957
1972,Heidelberg,Germany,South Africa,RSA,16,12,13,41,12,13,25,23281517
1972,Heidelberg,Germany,Spain,ESP,0,4,0,4,11,9,20,34604469
1972,Heidelberg,Germany,Sweden,SWE,5,6,6,17,30,8,38,8122300
1972,Heidelberg,Germany,Switzerland,SUI,3,2,4,9,32,4,36,6260956
1972,Heidelberg,Germany,Uganda,UGA,0,0,0,0,2,0,2,9929644
1972,Heidelberg,Germany,United States of America,USA,17,27,31,75,49,17,66,209896000
1972,Heidelberg,Germany,West Germany,FRG,28,17,22,67,52,23,75,
1972,Heidelberg,Germany,Yugoslavia,YUG,1,1,2,4,15,7,22,
1976,Toronto,Canada,Argentina,ARG,3,4,7,14,8,12,20,26264681
1976,Toronto,Canada,Australia,AUS,16,18,7,41,35,11,46,14033000
1976,Toronto,Canada,Austria,AUT,18,16,17,51,32,10,42,7565525
1976,Toronto,Canada,Bahamas,BAH,0,0,0,0,6,0,6,
1976,Toronto,Canada,Belgium,BEL,7,7,8,22,41,4,45,9818227
1976,Toronto,Canada,Brazil,BRA,0,1,0,1,21,2,23,109790943
1976,Toronto,Canada,Burma,MYA,1,1,1,3,4,0,4,
1976,Toronto,Canada,Canada,CAN,25,26,26,77,66,23,89,23449808
1976,Toronto,Canada,Colombia,COL,0,0,0,0,8,3,11,24608102
1976,Toronto,Canada,Denmark,DEN,3,0,3,6,19,2,21,5072596
1976,Toronto,Canada,Ecuador,ECU,0,0,0,0,3,0,3,7187794
1976,Toronto,Canada,Egypt,EGY,5,2,1,8,27,0,27,39422731
1976,Toronto,Canada,Ethiopia,ETH,0,0,0,0,1,0,1,33128151
1976,Toronto,Canada,Fiji,FIJ,0,0,0,0,9,0,9,587561
1976,Toronto,Canada,Finland,FIN,12,20,18,50,46,4,50,4725664
1976,Toronto,Canada,France,FRA,23,21,14,58,42,10,52,54220033
1976,Toronto,Canada,Great Britain,GBR,29,28,37,94,64,23,87,56211968
1976,Toronto,Canada,Greece,GRE,0,0,0,0,3,0,3,9188150
1976,Toronto,Canada,Guatemala,GUA,0,0,1,1,11,0,11,6269983
1976,Toronto,Canada,"Hong Kong, China",HKG,0,1,2,3,11,0,11,4518000
1976,Toronto,Canada,Hungary,HUN,1,0,1,2,2,0,2,10598677
1976,Toronto,Canada,Indonesia,INA,2,1,3,6,12,0,12,133966940
1976,Toronto,Canada,Ireland,IRL,4,10,6,20,8,11,19,3238050
1976,Toronto,Canada,Israel,ISR,40,13,16,69,50,9,59,3533000
1976,Toronto,Canada,Italy,ITA,2,5,11,18,22,2,24,55718260
1976,Toronto,Canada,Japan,JPN,10,6,3,19,30,4,34,112775000
1976,Toronto,Canada,Republic of Korea,KOR,1,2,1,4,7,0,7,35848523
1976,Toronto,Canada,Luxembourg,LUX,0,0,0,0,2,1,3,360731
1976,Toronto,Canada,Mexico,MEX,16,14,9,39,24,8,32,61242189
1976,Toronto,Canada,Netherlands,NED,45,25,14,84,41,17,58,13774037
1976,Toronto,Canada,New Zealand,NZL,7,1,5,13,11,1,12,3110500
1976,Toronto,Canada,Norway,NOR,9,6,4,19,26,15,41,4026152
1976,Toronto,Canada,Peru,PER,1,0,2,3,1,1,2,15838568
1976,Toronto,Canada,Poland,POL,24,17,12,53,23,14,37,34356300
1976,Toronto,Canada,South Africa,RSA,6,9,11,26,27,10,37,25836890
1976,Toronto,Canada,Spain,ESP,4,6,2,12,21,1,22,36137812
1976,Toronto,Canada,Sweden,SWE,21,28,25,74,56,13,69,8222286
1976,Toronto,Canada,Switzerland,SUI,9,12,10,31,40,9,49,6302504
1976,Toronto,Canada,Uganda,UGA,0,0,0,0,1,0,1,11042975
1976,Toronto,Canada,United States of America,USA,66,44,45,155,63,34,97,218035000
1976,Toronto,Canada,West Germany,FRG,37,34,26,97,76,17,93,
1980,Arnhem,Netherlands,Argentina,ARG,4,5,6,15,6,5,11,27896532
1980,Arnhem,Netherlands,Australia,AUS,12,21,22,55,40,12,52,14692000
1980,Arnhem,Netherlands,Austria,AUT,14,23,8,45,38,10,48,7549433
1980,Arnhem,Netherlands,Bahamas,BAH,0,1,2,3,2,4,6,
1980,Arnhem,Netherlands,Belgium,BEL,13,12,17,42,54,13,67,9859242
1980,Arnhem,Netherlands,Brazil,BRA,0,0,0,0,2,0,2,120694012
1980,Arnhem,Netherlands,Canada,CAN,64,35,31,130,60,34,94,24515667
1980,Arnhem,Netherlands,Colombia,COL,1,0,1,2,8,3,11,26900508
1980,Arnhem,Netherlands,Czechoslovakia,TCH,0,1,1,2,5,2,7,
1980,Arnhem,Netherlands,Denmark,DEN,6,4,7,17,32,10,42,5123027
1980,Arnhem,Netherlands,Egypt,EGY,4,7,3,14,26,7,33,43309063
1980,Arnhem,Netherlands,Ethiopia,ETH,0,0,0,0,1,0,1,35141703
1980,Arnhem,Netherlands,Finland,FIN,8,19,13,40,50,10,60,4779535
1980,Arnhem,Netherlands,France,FRA,28,26,31,85,76,21,97,55161510
1980,Arnhem,Netherlands,Great Britain,GBR,47,32,21,100,65,31,96,56314216
1980,Arnhem,Netherlands,Greece,GRE,0,0,1,1,6,1,7,9642505
1980,Arnhem,Netherlands,"Hong Kong, China",HKG,0,1,2,3,11,0,11,5063100
1980,Arnhem,Netherlands,Iceland,ISL,1,0,1,2,8,4,12,228138
1980,Arnhem,Netherlands,Indonesia,INA,2,0,4,6,15,0,15,147447834
1980,Arnhem,Netherlands,Ireland,IRL,4,2,11,17,14,9,23,3412800
1980,Arnhem,Netherlands,Israel,ISR,13,18,15,46,40,7,47,3878000
1980,Arnhem,Netherlands,Italy,ITA,6,5,9,20,29,9,38,56433883
1980,Arnhem,Netherlands,Jamaica,JAM,7,7,5,19,6,7,13,2162839
1980,Arnhem,Netherlands,Japan,JPN,9,10,7,26,24,6,30,116807000
1980,Arnhem,Netherlands,Kenya,KEN,1,2,0,3,13,4,17,16417203
1980,Arnhem,Netherlands,Republic of Korea,KOR,2,2,1,5,12,0,12,38123775
1980,Arnhem,Netherlands,Kuwait,KUW,2,2,1,5,7,2,9,1368680
1980,Arnhem,Netherlands,Luxembourg,LUX,0,0,1,1,8,1,9,364150
1980,Arnhem,Netherlands,Malta,MLT,0,0,1,1,5,3,8,316645
1980,Arnhem,Netherlands,Mexico,MEX,20,16,6,42,19,8,27,67761367
1980,Arnhem,Netherlands,Netherlands,NED,33,31,36,100,78,30,108,14149800
1980,Arnhem,Netherlands,New Zealand,NZL,7,6,6,19,12,5,17,3112900
1980,Arnhem,Netherlands,Norway,NOR,15,13,8,36,36,17,53,4085620
1980,Arnhem,Netherlands,Poland,POL,75,50,52,177,50,30,80,35574150
1980,Arnhem,Netherlands,Spain,ESP,1,13,9,23,17,7,24,37491165
1980,Arnhem,Netherlands,Sudan,SUD,1,0,0,1,8,3,11,14507466
1980,Arnhem,Netherlands,Sweden,SWE,31,36,24,91,75,19,94,8310531
1980,Arnhem,Netherlands,Switzerland,SUI,9,10,10,29,51,14,65,6319408
1980,Arnhem,Netherlands,United States of America,USA,75,66,54,195,85,47,132,227225000
1980,Arnhem,Netherlands,West Germany,FRG,68,48,46,162,104,24,128,
1980,Arnhem,Netherlands,Yugoslavia,YUG,4,5,9,18,25,6,31,
1980,Arnhem,Netherlands,Zimbabwe,ZIM,0,8,4,12,2,3,5,7408630
1984,"Stoke Mandeville, New York","Great Britain, United States of America",Argentina,ARG,0,0,0,0,6,0,6,29737097
1984,"Stoke Mandeville, New York","Great Britain, United States of America",Australia,AUS,49,54,51,154,80,28,108,15544000
1984,"Stoke Mandeville, New York","Great Britain, United States of America",Austria,AUT,14,20,10,44,37,8,45,7561434
1984,"Stoke Mandeville, New York","Great Britain, United States of America",Bahamas,BAH,0,1,1,2,0,2,2,
1984,"Stoke Mandeville, New York","Great Britain, United States of America",Bahrain,BRN,0,0,2,2,10,2,12,407233
1984,"Stoke Mandeville, New York","Great Britain, United States of America",Belgium,BEL,21,23,14,58,30,5,35,9855372
1984,"Stoke Mandeville, New York","Great Britain, United States of America",Brazil,BRA,7,17,4,28,24,6,30,132383569
1984,"Stoke Mandeville, New York","Great Britain, United States of America",Burma,MYA,1,2,1,4,10,0,10,
1984,"Stoke Mandeville, New York","Great Britain, United States of America",Canada,CAN,87,82,69,238,120,46,166,25607053
1984,"Stoke Mandeville, New York","Great Britain, United States of America",People's Republic of China,CHN,2,12,8,22,17,6,23,1036825000
1984,"Stoke Mandeville, New York","Great Britain, United States of America",Denmark,DEN,30,13,16,59,26,10,36,5111619
1984,"Stoke Mandeville, New York","Great Britain, United States of America",East Germany,GDR,0,3,1,4,3,1,4,
1984,"Stoke Mandeville, New York","Great Britain, United States of America",Ecuador,ECU,0,0,0,0,2,0,2,8843463
1984,"Stoke Mandeville, New York","Great Britain, United States of America",Egypt,EGY,1,1,5,7,25,3,28,47968643
1984,"Stoke Mandeville, New York","Great Britain, United States of America",Faroe Islands,FRO,0,0,0,0,1,2,3,44895
1984,"Stoke Mandeville, New York","Great Britain, United States of America",Finland,FIN,18,14,27,59,49,8,57,4881803
1984,"Stoke Mandeville, New York","Great Britain, United States of America",France,FRA,71,69,46,186,78,37,115,56337675
1984,"Stoke Mandeville, New York","Great Britain, United States of America",Great Britain,GBR,107,112,112,331,156,68,224,56422072
1984,"Stoke Mandeville, New York","Great Britain, United States of America",Greece,GRE,0,0,0,0,2,1,3,9895801
1984,"Stoke Mandeville, New York","Great Britain, United States of America",Guatemala,GUA,0,0,0,0,4,0,4,7669863
1984,"Stoke Mandeville, New York","Great Britain, United States of America","Hong Kong, China",HKG,3,5,9,17,14,11,25,5397900
1984,"Stoke Mandeville, New York","Great Britain, United States of America",Hungary,HUN,12,13,3,28,22,4,26,10668095
1984,"Stoke Mandeville, New York","Great Britain, United States of America",Iceland,ISL,0,2,8,10,8,5,13,239511
1984,"Stoke Mandeville, New York","Great Britain, United States of America",India,IND,0,2,2,4,5,0,5,766833411
1984,"Stoke Mandeville, New York","Great Britain, United States of America",Indonesia,INA,0,1,1,2,6,2,8,161523353
1984,"Stoke Mandeville, New York","Great Britain, United States of America",Ireland,IRL,20,15,31,66,38,13,51,3532423
1984,"Stoke Mandeville, New York","Great Britain, United States of America",Israel,ISR,11,21,12,44,41,6,47,4159000
1984,"Stoke Mandeville, New York","Great Britain, United States of America",Italy,ITA,9,19,14,42,47,13,60,56576718
1984,"Stoke Mandeville, New York","Great Britain, United States of America",Jamaica,JAM,0,0,0,0,1,0,1,2306367
1984,"Stoke Mandeville, New York","Great Britain, United States of America",Japan,JPN,9,7,8,24,27,10,37,120083000
1984,"Stoke Mandeville, New York","Great Britain, United States of America",Jordan,JOR,0,1,2,3,6,3,9,2784457
1984,"Stoke Mandeville, New York","Great Britain, United States of America",Kenya,KEN,1,1,1,3,11,2,13,19146403
1984,"Stoke Mandeville, New York","Great Britain, United States of America",Republic of Korea,KOR,0,2,2,4,15,3,18,40405956
1984,"Stoke Mandeville, New York","Great Britain, United States of America",Kuwait,KUW,1,3,4,8,20,2,22,1652150
1984,"Stoke Mandeville, New York","Great Britain, United States of America",Liechtenstein,LIE,0,0,0,0,0,1,1,27028
1984,"Stoke Mandeville, New York","Great Britain, United States of America",Luxembourg,LUX,1,4,1,6,5,0,5,365998
1984,"Stoke Mandeville, New York","Great Britain, United States of America",Malta,MLT,0,0,0,0,1,0,1,330593
1984,"Stoke Mandeville, New York","Great Britain, United States of America",Mexico,MEX,6,14,17,37,40,14,54,74352631
1984,"Stoke Mandeville, New York","Great Britain, United States of America",Netherlands,NED,55,52,28,135,40,21,61,14424211
1984,"Stoke Mandeville, New York","Great Britain, United States of America",New Zealand,NZL,8,10,7,25,9,4,13,3227100
1984,"Stoke Mandeville, New York","Great Britain, United States of America",Norway,NOR,30,30,30,90,42,22,64,4140099
1984,"Stoke Mandeville, New York","Great Britain, United States of America",Papua New Guinea,PNG,0,0,0,0,4,0,4,3975950
1984,"Stoke Mandeville, New York","Great Britain, United States of America",Poland,POL,46,39,21,106,25,9,34,36904134
1984,"Stoke Mandeville, New York","Great Britain, United States of America",Portugal,POR,4,3,7,14,15,2,17,9996232
1984,"Stoke Mandeville, New York","Great Britain, United States of America",Spain,ESP,22,10,12,44,20,9,29,38330364
1984,"Stoke Mandeville, New York","Great Britain, United States of America",Sweden,SWE,83,43,34,160,79,18,97,8336605
1984,"Stoke Mandeville, New York","Great Britain, United States of America",Switzerland,SUI,18,13,12,43,35,8,43,6441865
1984,"Stoke Mandeville, New York","Great Britain, United States of America",Thailand,THA,0,0,0,0,4,0,4,51094870
1984,"Stoke Mandeville, New York","Great Britain, United States of America",Trinidad and Tobago,TTO,2,0,1,3,7,1,8,1155083
1984,"Stoke Mandeville, New York","Great Britain, United States of America",United States of America,USA,137,131,129,397,157,79,236,235825000
1984,"Stoke Mandeville, New York","Great Britain, United States of America",Venezuela,VEN,0,0,0,0,6,0,6,16876703
1984,"Stoke Mandeville, New York","Great Britain, United States of America",West Germany,FRG,81,76,75,232,109,33,142,
1984,"Stoke Mandeville, New York","Great Britain, United States of America",Yugoslavia,YUG,11,10,11,32,25,5,30,
1984,"Stoke Mandeville, New York","Great Britain, United States of America",Zimbabwe,ZIM,0,1,2,3,5,3,8,8562259
1988,Seoul,Republic of Korea,Argentina,ARG,0,7,2,9,18,17,35,31668939
1988,Seoul,Republic of Korea,Australia,AUS,23,34,38,95,148,27,175,16532200
1988,Seoul,Republic of Korea,Austria,AUT,13,7,15,35,37,6,43,7585317
1988,Seoul,Republic of Korea,Bahamas,BAH,0,0,0,0,2,2,4,
1988,Seoul,Republic of Korea,Bahrain,BRN,1,1,1,3,11,0,11,465198
1988,Seoul,Republic of Korea,Belgium,BEL,15,18,8,41,46,8,54,9901664
1988,Seoul,Republic of Korea,Brazil,BRA,4,9,14,27,47,12,59,143627505
1988,Seoul,Republic of Korea,Bulgaria,BUL,2,1,0,3,8,0,8,8981446
1988,Seoul,Republic of Korea,Canada,CAN,55,42,55,152,104,53,157,26791747
1988,Seoul,Republic of Korea,People's Republic of China,CHN,16,17,8,41,27,14,41,1101630000
1988,Seoul,Republic of Korea,Colombia,COL,0,0,0,0,16,0,16,31822527
1988,Seoul,Republic of Korea,Cyprus,CYP,0,0,0,0,6,0,6,736476
1988,Seoul,Republic of Korea,Czechoslovakia,TCH,0,1,0,1,1,0,1,
1988,Seoul,Republic of Korea,Denmark,DEN,23,19,22,64,27,21,48,5129516
1988,Seoul,Republic of Korea,Egypt,EGY,1,3,3,7,45,1,46,53399243
1988,Seoul,Republic of Korea,Faroe Islands,FRO,1,3,3,7,1,3,4,46833
1988,Seoul,Republic of Korea,Finland,FIN,11,23,16,50,50,11,61,4946481
1988,Seoul,Republic of Korea,France,FRA,46,44,50,140,95,21,116,57627106
1988,Seoul,Republic of Korea,Great Britain,GBR,65,65,54,184,169,55,224,56928327
1988,Seoul,Republic of Korea,Greece,GRE,0,1,3,4,4,0,4,10036983
1988,Seoul,Republic of Korea,Guatemala,GUA,1,0,0,1,1,0,1,8566331
1988,Seoul,Republic of Korea,"Hong Kong, China",HKG,0,2,7,9,31,11,42,5627600
1988,Seoul,Republic of Korea,Hungary,HUN,0,5,7,12,31,3,34,10596487
1988,Seoul,Republic of Korea,Iceland,ISL,2,2,7,11,9,5,14,249740
1988,Seoul,Republic of Korea,India,IND,0,0,0,0,1,1,2,837468938
1988,Seoul,Republic of Korea,Indonesia,INA,0,2,0,2,17,2,19,174975953
1988,Seoul,Republic of Korea,Islamic Republic of Iran,IRI,4,1,3,8,36,0,36,53077312
1988,Seoul,Republic of Korea,Ireland,IRL,13,11,18,42,42,11,53,3524949
1988,Seoul,Republic of Korea,Israel,ISR,15,14,16,45,47,15,62,4442000
1988,Seoul,Republic of Korea,Italy,ITA,16,15,27,58,69,26,95,56629288
1988,Seoul,Republic of Korea,Jamaica,JAM,1,4,3,8,2,3,5,2389415
1988,Seoul,Republic of Korea,Japan,JPN,17,12,17,46,109,34,143,122578000
1988,Seoul,Republic of Korea,Jordan,JOR,0,0,0,0,5,2,7,3256552
1988,Seoul,Republic of Korea,Kenya,KEN,0,4,1,5,9,3,12,22153685
1988,Seoul,Republic of Korea,Republic of Korea,KOR,40,35,19,94,205,21,226,42031247
1988,Seoul,Republic of Korea,Kuwait,KUW,5,5,7,17,27,3,30,2034850
1988,Seoul,Republic of Korea,Liechtenstein,LIE,0,0,0,0,1,1,2,28135
1988,Seoul,Republic of Korea,"Macao, China",MAC,0,0,0,0,6,1,7,
1988,Seoul,Republic of Korea,Malaysia,MAS,0,0,1,1,12,2,14,17022470
1988,Seoul,Republic of Korea,Mexico,MEX,8,9,7,24,28,5,33,80788725
1988,Seoul,Republic of Korea,Morocco,MAR,0,0,1,1,14,0,14,23903592
1988,Seoul,Republic of Korea,Netherlands,NED,30,24,29,83,76,34,110,14760094
1988,Seoul,Republic of Korea,New Zealand,NZL,2,4,11,17,11,5,16,3283400
1988,Seoul,Republic of Korea,Norway,NOR,11,11,15,37,28,6,34,4209488
1988,Seoul,Republic of Korea,Oman,OMA,0,0,0,0,9,0,9,1678119
1988,Seoul,Republic of Korea,Philippines,PHI,0,0,0,0,4,0,4,58794999
1988,Seoul,Republic of Korea,Poland,POL,23,25,33,81,39,7,46,37824487
1988,Seoul,Republic of Korea,Portugal,POR,3,5,6,14,7,6,13,10019610
1988,Seoul,Republic of Korea,Puerto Rico,PUR,1,2,0,3,12,1,13,3473898
1988,Seoul,Republic of Korea,Singapore,SGP,0,0,0,0,7,1,8,2846108
1988,Seoul,Republic of Korea,Spain,ESP,18,13,12,43,42,8,50,38766939
1988,Seoul,Republic of Korea,Sweden,SWE,42,38,23,103,79,24,103,8436489
1988,Seoul,Republic of Korea,Switzerland,SUI,12,12,11,35,33,8,41,6593386
1988,Seoul,Republic of Korea,Thailand,THA,0,1,0,1,10,0,10,54891520
1988,Seoul,Republic of Korea,Trinidad and Tobago,TTO,0,0,0,0,4,0,4,1204150
1988,Seoul,Republic of Korea,Tunisia,TUN,0,0,2,2,1,0,1,7880333
1988,Seoul,Republic of Korea,United States of America,USA,91,90,88,269,253,118,371,244499000
1988,Seoul,Republic of Korea,USSR,URS,21,20,15,56,16,6,22,
1988,Seoul,Republic of Korea,West Germany,FRG,76,65,52,193,145,43,188,
1988,Seoul,Republic of Korea,Yugoslavia,YUG,4,4,11,19,30,4,34,
1992,Barcelona,Spain,Algeria,ALG,0,0,0,0,8,0,8,27028330
1992,Barcelona,Spain,Argentina,ARG,1,1,0,2,26,1,27,33529320
1992,Barcelona,Spain,Australia,AUS,24,27,25,76,93,41,134,17495000
1992,Barcelona,Spain,Austria,AUT,5,4,13,22,31,5,36,7840709
1992,Barcelona,Spain,Bahrain,BRN,0,0,1,1,4,0,4,523082
1992,Barcelona,Spain,Belarus,BLR,0,0,0,0,1,0,1,10216000
1992,Barcelona,Spain,Belgium,BEL,5,5,7,17,64,9,73,10045158
1992,Barcelona,Spain,Brazil,BRA,3,0,4,7,31,10,41,154259382
1992,Barcelona,Spain,Bulgaria,BUL,1,2,0,3,5,2,7,8540164
1992,Barcelona,Spain,Burkina Faso,BUR,0,0,0,0,3,0,3,9297110
1992,Barcelona,Spain,Canada,CAN,28,21,26,75,89,49,138,28371264
1992,Barcelona,Spain,Chile,CHI,0,0,0,0,2,0,2,13719818
1992,Barcelona,Spain,People's Republic of China,CHN,11,7,7,25,13,11,24,1164970000
1992,Barcelona,Spain,Chinese Taipei,TPE,0,0,1,1,10,1,11,
1992,Barcelona,Spain,Colombia,COL,0,0,0,0,4,2,6,34422568
1992,Barcelona,Spain,Costa Rica,CRC,0,0,0,0,2,0,2,3286525
1992,Barcelona,Spain,Croatia,CRO,0,0,1,1,5,1,6,4575818
1992,Barcelona,Spain,Cuba,CUB,3,3,3,9,10,0,10,10736386
1992,Barcelona,Spain,Cyprus,CYP,0,0,0,0,4,0,4,800610
1992,Barcelona,Spain,Czechoslovakia,TCH,4,3,6,13,24,5,29,
1992,Barcelona,Spain,Denmark,DEN,12,22,12,46,22,21,43,5171370
1992,Barcelona,Spain,Dominican Republic,DOM,0,0,0,0,1,0,1,7408339
1992,Barcelona,Spain,Ecuador,ECU,0,0,0,0,3,0,3,10716131
1992,Barcelona,Spain,Egypt,EGY,7,6,7,20,41,0,41,58666812
1992,Barcelona,Spain,Estonia,EST,0,2,1,3,2,4,6,1533091
1992,Barcelona,Spain,Faroe Islands,FRO,0,1,0,1,1,2,3,46746
1992,Barcelona,Spain,Finland,FIN,8,6,11,25,54,13,67,5041992
1992,Barcelona,Spain,France,FRA,36,36,34,106,106,39,145,58851216
1992,Barcelona,Spain,Germany,GER,61,51,59,171,174,64,238,80624598
1992,Barcelona,Spain,Great Britain,GBR,40,47,41,128,156,52,208,57580402
1992,Barcelona,Spain,Greece,GRE,0,2,1,3,7,0,7,10399061
1992,Barcelona,Spain,"Hong Kong, China",HKG,3,4,4,11,16,5,21,5800500
1992,Barcelona,Spain,Hungary,HUN,4,3,4,11,34,9,43,10369341
1992,Barcelona,Spain,Iceland,ISL,3,2,12,17,8,4,12,261057
1992,Barcelona,Spain,Independent Paralympic Participants,IPP,4,3,1,8,13,3,16,
1992,Barcelona,Spain,India,IND,0,0,0,0,7,2,9,909307018
1992,Barcelona,Spain,Islamic Republic of Iran,IRI,1,2,1,4,25,4,29,58780376
1992,Barcelona,Spain,Iraq,IRQ,0,0,1,1,18,0,18,18402740
1992,Barcelona,Spain,Ireland,IRL,0,3,4,7,40,18,58,3558430
1992,Barcelona,Spain,Israel,ISR,2,4,5,11,56,6,62,5123000
1992,Barcelona,Spain,Italy,ITA,10,7,18,35,69,18,87,56797087
1992,Barcelona,Spain,Jamaica,JAM,0,1,2,3,2,2,4,2461047
1992,Barcelona,Spain,Japan,JPN,8,7,15,30,54,22,76,124425000
1992,Barcelona,Spain,Kenya,KEN,1,0,1,2,9,6,15,25326080
1992,Barcelona,Spain,Republic of Korea,KOR,11,15,18,44,64,2,66,43747962
1992,Barcelona,Spain,Kuwait,KUW,1,3,1,5,21,3,24,
1992,Barcelona,Spain,Latvia,LAT,0,0,0,0,2,0,2,2614338
1992,Barcelona,Spain,Liechtenstein,LIE,0,0,0,0,3,0,3,29552
1992,Barcelona,Spain,Lithuania,LTU,0,4,3,7,1,3,4,3700114
1992,Barcelona,Spain,Luxembourg,LUX,0,0,0,0,2,0,2,392175
1992,Barcelona,Spain,"Macao, China",MAC,0,0,0,0,2,0,2,
1992,Barcelona,Spain,Malaysia,MAS,0,1,2,3,10,0,10,19002660
1992,Barcelona,Spain,Mexico,MEX,0,1,10,11,9,10,19,87075136
1992,Barcelona,Spain,Morocco,MAR,0,0,0,0,5,0,5,25711410
1992,Barcelona,Spain,Myanmar,MYA,0,0,0,0,1,0,1,42401686
1992,Barcelona,Spain,Namibia,NAM,0,0,0,0,0,2,2,1516951
1992,Barcelona,Spain,Netherlands,NED,14,14,11,39,72,27,99,15184166
1992,Barcelona,Spain,New Zealand,NZL,5,1,0,6,9,4,13,3531700
1992,Barcelona,Spain,Nigeria,NGR,3,0,0,3,6,0,6,100161708
1992,Barcelona,Spain,Norway,NOR,13,13,7,33,33,5,38,4286401
1992,Barcelona,Spain,Oman,OMA,0,0,0,0,4,0,4,1983272
1992,Barcelona,Spain,Pakistan,PAK,0,0,0,0,2,0,2,113911126
1992,Barcelona,Spain,Panama,PAN,1,2,0,3,2,0,2,2575949
1992,Barcelona,Spain,Poland,POL,10,12,10,32,36,4,40,38363667
1992,Barcelona,Spain,Portugal,POR,3,3,3,9,26,4,30,9952494
1992,Barcelona,Spain,Puerto Rico,PUR,0,0,0,0,8,1,9,3585176
1992,Barcelona,Spain,Seychelles,SEY,0,0,0,0,2,0,2,70763
1992,Barcelona,Spain,Singapore,SGP,0,0,0,0,3,1,4,3230698
1992,Barcelona,Spain,Slovenia,SLO,2,0,1,3,7,1,8,1996498
1992,Barcelona,Spain,South Africa,RSA,4,1,3,8,9,1,10,38672611
1992,Barcelona,Spain,Spain,ESP,34,31,42,107,167,66,233,39157685
1992,Barcelona,Spain,Sweden,SWE,7,22,9,38,72,27,99,8668067
1992,Barcelona,Spain,Switzerland,SUI,6,16,13,35,36,5,41,6875364
1992,Barcelona,Spain,Syrian Arab Republic,SYR,0,0,0,0,2,0,2,13187669
1992,Barcelona,Spain,Tanzania,TAN,0,0,0,0,1,0,1,
1992,Barcelona,Spain,Thailand,THA,0,0,1,1,5,0,5,57811025
1992,Barcelona,Spain,Tunisia,TUN,0,0,0,0,1,0,1,8613855
1992,Barcelona,Spain,Turkey,TUR,0,0,0,0,1,0,1,55748946
1992,Barcelona,Spain,Unified Team,EUN,16,14,15,45,50,11,61,
1992,Barcelona,Spain,United Arab Emirates,UAE,0,0,0,0,1,0,1,2052892
1992,Barcelona,Spain,United States of America,USA,75,52,48,175,264,90,354,256514000
1992,Barcelona,Spain,Uruguay,URU,0,0,0,0,2,0,2,3154459
1992,Barcelona,Spain,Venezuela,VEN,0,0,1,1,9,1,10,20557694
1992,Barcelona,Spain,Yemen,YEM,0,0,0,0,3,0,3,12954157
1996,Atlanta,United States of America,Afghanistan,AFG,0,0,0,0,2,0,2,18853444
1996,Atlanta,United States of America,Algeria,ALG,2,2,3,7,9,0,9,29266415
1996,Atlanta,United States of America,Angola,ANG,0,0,0,0,2,0,2,14400722
1996,Atlanta,United States of America,Argentina,ARG,2,5,2,9,49,7,56,35246376
1996,Atlanta,United States of America,Armenia,ARM,0,0,0,0,5,0,5,3168213
1996,Atlanta,United States of America,Australia,AUS,42,37,27,106,99,62,161,18311000
1996,Atlanta,United States of America,Austria,AUT,6,6,10,22,44,5,49,7959017
1996,Atlanta,United States of America,Azerbaijan,AZE,0,0,0,0,2,0,2,7763000
1996,Atlanta,United States of America,Bahrain,BRN,0,0,0,0,6,0,6,578661
1996,Atlanta,United States of America,Belarus,BLR,3,3,7,13,11,4,15,10160000
1996,Atlanta,United States of America,Belgium,BEL,8,10,7,25,32,6,38,10156637
1996,Atlanta,United States of America,Bermuda,BER,0,0,0,0,0,2,2,60129
1996,Atlanta,United States of America,Bosnia and Herzegovina,BIH,0,0,0,0,3,0,3,3764419
1996,Atlanta,United States of America,Brazil,BRA,2,6,13,21,41,19,60,164614682
1996,Atlanta,United States of America,Bulgaria,BUL,0,1,1,2,4,2,6,8362826
1996,Atlanta,United States of America,Burkina Faso,BUR,0,0,0,0,3,0,3,10372734
1996,Atlanta,United States of America,Canada,CAN,24,21,24,69,94,38,132,29610218
1996,Atlanta,United States of America,Chile,CHI,0,0,0,0,2,0,2,14587367
1996,Atlanta,United States of America,People's Republic of China,CHN,16,13,10,39,27,10,37,1217550000
1996,Atlanta,United States of America,Chinese Taipei,TPE,1,0,2,3,13,1,14,
1996,Atlanta,United States of America,Colombia,COL,0,0,0,0,2,0,2,37076387
1996,Atlanta,United States of America,Côte d'Ivoire,CIV,2,0,0,2,2,0,2,
1996,Atlanta,United States of America,Croatia,CRO,0,0,0,0,2,3,5,4557097
1996,Atlanta,United States of America,Cuba,CUB,8,3,0,11,9,1,10,10939285
1996,Atlanta,United States of America,Cyprus,CYP,0,0,0,0,4,0,4,873426
1996,Atlanta,United States of America,Czech Republic,CZE,2,7,1,10,36,7,43,10315241
1996,Atlanta,United States of America,Denmark,DEN,7,17,17,41,25,20,45,5263074
1996,Atlanta,United States of America,Dominican Republic,DOM,1,0,0,1,2,0,2,7952766
1996,Atlanta,United States of America,Ecuador,ECU,0,0,0,0,2,0,2,11703169
1996,Atlanta,United States of America,Egypt,EGY,8,11,11,30,26,5,31,63601632
1996,Atlanta,United States of America,Estonia,EST,3,4,2,9,2,8,10,1415594
1996,Atlanta,United States of America,Faroe Islands,FRO,0,0,0,0,0,1,1,45624
1996,Atlanta,United States of America,Fiji,FIJ,0,0,0,0,2,0,2,784389
1996,Atlanta,United States of America,Finland,FIN,4,5,4,13,53,12,65,5124573
1996,Atlanta,United States of America,France,FRA,35,29,31,95,122,25,147,59753095
1996,Atlanta,United States of America,Germany,GER,40,58,51,149,153,78,231,81914831
1996,Atlanta,United States of America,Great Britain,GBR,39,42,41,122,165,83,248,58166950
1996,Atlanta,United States of America,Greece,GRE,1,1,3,5,16,0,16,10608800
1996,Atlanta,United States of America,Honduras,HON,0,0,0,0,2,0,2,5874814
1996,Atlanta,United States of America,"Hong Kong, China",HKG,5,5,5,15,19,5,24,6435500
1996,Atlanta,United States of America,Hungary,HUN,5,2,3,10,32,10,42,10311238
1996,Atlanta,United States of America,Iceland,ISL,5,4,5,14,6,4,10,268916
1996,Atlanta,United States of America,India,IND,0,0,0,0,9,0,9,982365248
1996,Atlanta,United States of America,Indonesia,INA,0,0,0,0,1,0,1,199901231
1996,Atlanta,United States of America,Islamic Republic of Iran,IRI,9,5,3,17,28,2,30,62294919
1996,Atlanta,United States of America,Ireland,IRL,1,3,6,10,46,17,63,3637510
1996,Atlanta,United States of America,Israel,ISR,0,4,5,9,37,3,40,5692000
1996,Atlanta,United States of America,Italy,ITA,11,20,14,45,59,19,78,56860281
1996,Atlanta,United States of America,Jamaica,JAM,0,0,1,1,2,1,3,2558631
1996,Atlanta,United States of America,Japan,JPN,14,10,13,37,58,23,81,125757000
1996,Atlanta,United States of America,Jordan,JOR,0,1,0,1,5,0,5,4732848
1996,Atlanta,United States of America,Kazakhstan,KAZ,0,0,0,0,13,0,13,15578227
1996,Atlanta,United States of America,Kenya,KEN,1,1,0,2,11,6,17,28589456
1996,Atlanta,United States of America,Republic of Korea,KOR,13,2,15,30,55,9,64,45524681
1996,Atlanta,United States of America,Kuwait,KUW,1,1,1,3,17,0,17,1626858
1996,Atlanta,United States of America,Kyrgyzstan,KGZ,0,0,0,0,2,0,2,4628400
1996,Atlanta,United States of America,Latvia,LAT,0,0,0,0,4,1,5,2457222
1996,Atlanta,United States of America,Libya,LBA,0,0,0,0,4,0,4,5036173
1996,Atlanta,United States of America,Lithuania,LTU,3,2,6,11,6,3,9,3601613
1996,Atlanta,United States of America,Luxembourg,LUX,0,0,0,0,1,0,1,414225
1996,Atlanta,United States of America,"Macao, China",MAC,0,0,0,0,1,0,1,
1996,Atlanta,United States of America,Malaysia,MAS,0,0,0,0,6,0,6,21017619
1996,Atlanta,United States of America,Mauritius,MRI,0,0,0,0,2,0,2,1133996
1996,Atlanta,United States of America,Mexico,MEX,3,5,4,12,28,10,38,93147045
1996,Atlanta,United States of America,Republic of Moldova,MDA,0,0,2,2,5,0,5,2946401
1996,Atlanta,United States of America,Morocco,MAR,0,0,0,0,4,0,4,27383472
1996,Atlanta,United States of America,Netherlands,NED,17,11,17,45,73,33,106,15530498
1996,Atlanta,United States of America,New Zealand,NZL,9,6,3,18,28,6,34,3732000
1996,Atlanta,United States of America,Nigeria,NGR,3,2,3,8,8,0,8,110668784
1996,Atlanta,United States of America,North Macedonia,MKD,0,0,0,0,1,0,1,1989441
1996,Atlanta,United States of America,Norway,NOR,9,7,4,20,35,7,42,4381336
1996,Atlanta,United States of America,Oman,OMA,0,0,0,0,3,0,3,2236652
1996,Atlanta,United States of America,Pakistan,PAK,0,0,0,0,1,0,1,127349293
1996,Atlanta,United States of America,Panama,PAN,2,0,0,2,1,0,1,2796291
1996,Atlanta,United States of America,Peru,PER,1,0,0,1,3,0,3,24753825
1996,Atlanta,United States of America,Poland,POL,13,14,8,35,49,12,61,38624370
1996,Atlanta,United States of America,Portugal,POR,6,4,4,14,29,6,35,10063945
1996,Atlanta,United States of America,Puerto Rico,PUR,0,0,0,0,3,2,5,3724655
1996,Atlanta,United States of America,Qatar,QAT,0,0,0,0,1,0,1,522531
1996,Atlanta,United States of America,Romania,ROU,0,0,0,0,1,0,1,22619004
1996,Atlanta,United States of America,Russian Federation,RUS,9,7,11,27,60,10,70,
1996,Atlanta,United States of America,Saudi Arabia,KSA,0,0,0,0,2,0,2,19033843
1996,Atlanta,United States of America,Serbia and Montenegro,SCG,0,0,0,0,3,1,4,
1996,Atlanta,United States of America,Sierra Leone,SLE,0,0,0,0,1,0,1,4312660
1996,Atlanta,United States of America,Singapore,SGP,0,0,0,0,1,2,3,3670704
1996,Atlanta,United States of America,Slovakia,SVK,2,4,5,11,23,5,28,5373361
1996,Atlanta,United States of America,Slovenia,SLO,0,2,3,5,13,1,14,1988628
1996,Atlanta,United States of America,South Africa,RSA,10,8,10,28,29,11,40,42241007
1996,Atlanta,United States of America,Spain,ESP,39,31,36,106,146,50,196,39889852
1996,Atlanta,United States of America,Sri Lanka,SRI,0,0,0,0,1,0,1,18367290
1996,Atlanta,United States of America,Sweden,SWE,12,14,11,37,83,27,110,8840998
1996,Atlanta,United States of America,Switzerland,SUI,9,6,6,21,36,9,45,7071850
1996,Atlanta,United States of America,Syrian Arab Republic,SYR,0,0,0,0,2,0,2,14754148
1996,Atlanta,United States of America,Thailand,THA,0,0,2,2,7,0,7,60130190
1996,Atlanta,United States of America,Tunisia,TUN,0,2,0,2,2,1,3,9267335
1996,Atlanta,United States of America,Uganda,UGA,0,0,0,0,1,0,1,21032817
1996,Atlanta,United States of America,Ukraine,UKR,1,4,2,7,25,5,30,51057800
1996,Atlanta,United States of America,United Arab Emirates,UAE,0,0,0,0,5,0,5,2539121
1996,Atlanta,United States of America,United States of America,USA,46,46,65,157,239,89,328,269394000
1996,Atlanta,United States of America,Uruguay,URU,0,0,1,1,1,0,1,3247383
1996,Atlanta,United States of America,Venezuela,VEN,0,0,0,0,4,0,4,22385650
1996,Atlanta,United States of America,Yugoslavia,YUG,2,2,0,4,5,1,6,
1996,Atlanta,United States of America,Zambia,ZAM,0,0,0,0,1,0,1,9339740
1996,Atlanta,United States of America,Zimbabwe,ZIM,0,0,0,0,2,0,2,11541215
2000,Sydney,Australia,Algeria,ALG,3,0,0,3,7,1,8,31042238
2000,Sydney,Australia,Angola,ANG,0,0,0,0,1,0,1,16395477
2000,Sydney,Australia,Argentina,ARG,0,2,3,5,31,12,43,36870796
2000,Sydney,Australia,Armenia,ARM,0,0,0,0,4,0,4,3069597
2000,Sydney,Australia,Australia,AUS,63,39,47,149,193,93,286,19153000
2000,Sydney,Australia,Austria,AUT,2,7,6,15,47,5,52,8011566
2000,Sydney,Australia,Azerbaijan,AZE,0,1,0,1,6,1,7,8048600
2000,Sydney,Australia,Bahrain,BRN,0,1,1,2,3,0,3,664610
2000,Sydney,Australia,Barbados,BAR,0,0,0,0,1,0,1,271511
2000,Sydney,Australia,Belarus,BLR,5,8,10,23,15,7,22,9979610
2000,Sydney,Australia,Belgium,BEL,1,4,4,9,25,5,30,10251250
2000,Sydney,Australia,Benin,BEN,0,0,0,0,1,0,1,6865946
2000,Sydney,Australia,Bermuda,BER,0,0,0,0,1,1,2,61833
2000,Sydney,Australia,Bosnia and Herzegovina,BIH,0,1,0,1,13,0,13,3751176
2000,Sydney,Australia,Brazil,BRA,6,10,6,22,52,11,63,174790339
2000,Sydney,Australia,Bulgaria,BUL,1,0,0,1,3,1,4,8170172
2000,Sydney,Australia,Burkina Faso,BUR,0,0,0,0,1,0,1,11607951
2000,Sydney,Australia,Cambodia,CAM,0,0,0,0,11,0,11,12155241
2000,Sydney,Australia,Canada,CAN,38,33,25,96,112,53,165,30685730
2000,Sydney,Australia,Chile,CHI,0,0,0,0,4,0,4,15342350
2000,Sydney,Australia,People's Republic of China,CHN,34,22,17,73,54,33,87,1262645000
2000,Sydney,Australia,Chinese Taipei,TPE,1,2,4,7,17,8,25,
2000,Sydney,Australia,Colombia,COL,0,0,0,0,3,0,3,39629965
2000,Sydney,Australia,Costa Rica,CRC,0,0,0,0,1,0,1,3962369
2000,Sydney,Australia,Côte d'Ivoire,CIV,1,0,1,2,2,0,2,
2000,Sydney,Australia,Croatia,CRO,0,0,0,0,10,5,15,4468302
2000,Sydney,Australia,Cuba,CUB,4,2,2,8,9,1,10,11126423
2000,Sydney,Australia,Cyprus,CYP,0,0,0,0,3,1,4,943288
2000,Sydney,Australia,Czech Republic,CZE,15,15,13,43,41,16,57,10255063
2000,Sydney,Australia,Denmark,DEN,8,8,14,30,26,12,38,5339616
2000,Sydney,Australia,Ecuador,ECU,0,0,0,0,2,1,3,12681123
2000,Sydney,Australia,Egypt,EGY,6,12,10,28,33,12,45,68831561
2000,Sydney,Australia,El Salvador,ESA,0,0,0,0,0,1,1,5887930
2000,Sydney,Australia,Estonia,EST,1,1,3,5,4,6,10,1396985
2000,Sydney,Australia,Faroe Islands,FRO,0,3,1,4,0,2,2,46738
2000,Sydney,Australia,Fiji,FIJ,0,0,0,0,4,0,4,811011
2000,Sydney,Australia,Finland,FIN,1,3,6,10,38,11,49,5176209
2000,Sydney,Australia,France,FRA,30,28,28,86,116,30,146,60912500
2000,Sydney,Australia,Germany,GER,16,41,38,95,181,69,250,82211508
2000,Sydney,Australia,Great Britain,GBR,41,43,47,131,140,74,214,58892514
2000,Sydney,Australia,Greece,GRE,4,4,3,11,41,3,44,10805808
2000,Sydney,Australia,Honduras,HON,0,0,0,0,1,0,1,6574510
2000,Sydney,Australia,"Hong Kong, China",HKG,8,3,7,18,22,6,28,6665000
2000,Sydney,Australia,Hungary,HUN,4,5,14,23,41,13,54,10210971
2000,Sydney,Australia,Iceland,ISL,2,0,2,4,5,1,6,281205
2000,Sydney,Australia,India,IND,0,0,0,0,4,0,4,1056575548
2000,Sydney,Australia,Individual Paralympic Athletes,IPA,0,0,0,0,2,0,2,
2000,Sydney,Australia,Indonesia,INA,0,0,0,0,4,0,4,211513822
2000,Sydney,Australia,Islamic Republic of Iran,IRI,12,4,7,23,36,4,40,65623397
2000,Sydney,Australia,Iraq,IRQ,0,0,0,0,3,0,3,23497589
2000,Sydney,Australia,Ireland,IRL,5,3,1,9,23,15,38,3805174
2000,Sydney,Australia,Israel,ISR,3,2,1,6,31,2,33,6289000
2000,Sydney,Australia,Italy,ITA,9,8,10,27,50,16,66,56942108
2000,Sydney,Australia,Jamaica,JAM,0,0,0,0,3,2,5,2654698
2000,Sydney,Australia,Japan,JPN,13,17,11,41,111,40,151,126843000
2000,Sydney,Australia,Jordan,JOR,1,0,0,1,5,2,7,5122495
2000,Sydney,Australia,Kazakhstan,KAZ,0,0,0,0,2,0,2,14883626
2000,Sydney,Australia,Kenya,KEN,1,1,2,4,8,5,13,31964557
2000,Sydney,Australia,Republic of Korea,KOR,18,7,7,32,82,7,89,47008111
2000,Sydney,Australia,Kuwait,KUW,0,1,4,5,22,4,26,2045123
2000,Sydney,Australia,Kyrgyzstan,KGZ,0,0,0,0,2,0,2,4898400
2000,Sydney,Australia,Lao People's Democratic Republic,LAO,0,0,0,0,1,1,2,5323701
2000,Sydney,Australia,Latvia,LAT,0,0,3,3,4,1,5,2367550
2000,Sydney,Australia,Lebanon,LBN,0,0,0,0,2,0,2,3842774
2000,Sydney,Australia,Lesotho,LES,0,0,0,0,1,1,2,2032805
2000,Sydney,Australia,Libya,LBA,0,0,1,1,16,1,17,5357893
2000,Sydney,Australia,Lithuania,LTU,0,2,1,3,14,3,17,3499536
2000,Sydney,Australia,"Macao, China",MAC,0,0,0,0,1,1,2,
2000,Sydney,Australia,Madagascar,MAD,0,0,0,0,1,0,1,15766806
2000,Sydney,Australia,Malaysia,MAS,0,0,0,0,8,2,10,23194252
2000,Sydney,Australia,Mali,MLI,0,0,0,0,1,0,1,10946448
2000,Sydney,Australia,Mauritania,MTN,0,0,0,0,1,1,2,2630217
2000,Sydney,Australia,Mexico,MEX,10,12,12,34,48,29,77,98899845
2000,Sydney,Australia,Republic of Moldova,MDA,0,0,0,0,6,0,6,2923783
2000,Sydney,Australia,Mongolia,MGL,0,0,0,0,2,0,2,2397417
2000,Sydney,Australia,Morocco,MAR,0,0,0,0,5,2,7,28793672
2000,Sydney,Australia,Netherlands,NED,12,9,9,30,68,33,101,15925513
2000,Sydney,Australia,New Zealand,NZL,6,8,4,18,36,6,42,3857700
2000,Sydney,Australia,Nigeria,NGR,7,1,5,13,18,11,29,122283853
2000,Sydney,Australia,North Macedonia,MKD,0,0,0,0,2,0,2,2034823
2000,Sydney,Australia,Norway,NOR,2,6,7,15,26,13,39,4490967
2000,Sydney,Australia,Oman,OMA,0,0,0,0,3,0,3,2267973
2000,Sydney,Australia,Pakistan,PAK,0,0,0,0,1,0,1,142343583
2000,Sydney,Australia,Palestine,PLE,0,0,1,1,1,1,2,
2000,Sydney,Australia,Panama,PAN,0,1,1,2,1,0,1,3030333
2000,Sydney,Australia,Papua New Guinea,PNG,0,0,0,0,3,0,3,5847590
2000,Sydney,Australia,Peru,PER,1,1,0,2,3,1,4,26459944
2000,Sydney,Australia,Philippines,PHI,0,0,1,1,1,1,2,77991757
2000,Sydney,Australia,Poland,POL,19,22,12,53,86,27,113,38258629
2000,Sydney,Australia,Portugal,POR,6,5,4,15,45,7,52,10289898
2000,Sydney,Australia,Puerto Rico,PUR,0,0,1,1,1,2,3,3810605
2000,Sydney,Australia,Qatar,QAT,0,0,0,0,3,0,3,592467
2000,Sydney,Australia,Romania,ROU,0,0,0,0,1,0,1,22442971
2000,Sydney,Australia,Russian Federation,RUS,12,11,12,35,69,20,89,
2000,Sydney,Australia,Rwanda,RWA,0,0,0,0,1,0,1,7933688
2000,Sydney,Australia,Samoa,SAM,0,0,0,0,1,0,1,174454
2000,Sydney,Australia,Saudi Arabia,KSA,0,0,0,0,4,0,4,20663840
2000,Sydney,Australia,Serbia and Montenegro,SCG,0,0,0,0,3,1,4,
2000,Sydney,Australia,Singapore,SGP,0,0,0,0,1,2,3,4027887
2000,Sydney,Australia,Slovakia,SVK,3,5,5,13,34,11,45,5388720
2000,Sydney,Australia,Slovenia,SLO,0,2,2,4,15,2,17,1988925
2000,Sydney,Australia,South Africa,RSA,13,12,13,38,50,16,66,44967713
2000,Sydney,Australia,Spain,ESP,38,30,38,106,157,52,209,40567864
2000,Sydney,Australia,Sri Lanka,SRI,0,0,0,0,3,0,3,18777606
2000,Sydney,Australia,Sweden,SWE,5,6,10,21,70,17,87,8872109
2000,Sydney,Australia,Switzerland,SUI,8,4,8,20,44,9,53,7184250
2000,Sydney,Australia,Syrian Arab Republic,SYR,0,0,0,0,3,1,4,16410847
2000,Sydney,Australia,Thailand,THA,5,4,2,11,35,6,41,62952639
2000,Sydney,Australia,Tonga,TGA,0,0,0,0,0,1,1,97962
2000,Sydney,Australia,Tunisia,TUN,6,4,1,11,8,2,10,9708347
2000,Sydney,Australia,Turkey,TUR,0,0,0,0,1,0,1,63240196
2000,Sydney,Australia,Turkmenistan,TKM,0,0,0,0,1,0,1,4516128
2000,Sydney,Australia,Uganda,UGA,0,0,0,0,0,1,1,23650159
2000,Sydney,Australia,Ukraine,UKR,3,20,14,37,49,18,67,49176500
2000,Sydney,Australia,United Arab Emirates,UAE,0,3,1,4,14,0,14,3134067
2000,Sydney,Australia,United States of America,USA,36,39,34,109,181,86,267,282162411
2000,Sydney,Australia,Uruguay,URU,0,0,0,0,1,1,2,3319734
2000,Sydney,Australia,Vanuatu,VAN,0,0,0,0,1,1,2,184964
2000,Sydney,Australia,Venezuela,VEN,0,0,1,1,8,2,10,24192449
2000,Sydney,Australia,Vietnam,VIE,0,0,0,0,1,1,2,79910411
2000,Sydney,Australia,Yugoslavia,YUG,0,1,0,1,2,0,2,
2000,Sydney,Australia,Zambia,ZAM,0,0,0,0,1,1,2,10415942
2000,Sydney,Australia,Zimbabwe,ZIM,1,0,0,1,2,1,3,11881482
2004,Athens,Greece,Afghanistan,AFG,0,0,0,0,1,2,3,24726689
2004,Athens,Greece,Algeria,ALG,6,2,5,13,14,4,18,32692153
2004,Athens,Greece,Angola,ANG,3,0,0,3,3,1,4,18758138
2004,Athens,Greece,Argentina,ARG,0,2,2,4,42,11,53,38491970
2004,Athens,Greece,Armenia,ARM,0,0,0,0,1,1,2,3000715
2004,Athens,Greece,Australia,AUS,26,39,36,101,89,56,145,20127400
2004,Athens,Greece,Austria,AUT,8,10,4,22,40,4,44,8171966
2004,Athens,Greece,Azerbaijan,AZE,2,1,1,4,8,1,9,8306500
2004,Athens,Greece,Bahrain,BRN,0,1,0,1,5,0,5,829846
2004,Athens,Greece,Bangladesh,BAN,0,0,0,0,1,0,1,136986429
2004,Athens,Greece,Barbados,BAR,0,0,0,0,1,0,1,275283
2004,Athens,Greece,Belarus,BLR,10,12,7,29,19,11,30,9730146
2004,Athens,Greece,Belgium,BEL,3,2,2,7,24,1,25,10421137
2004,Athens,Greece,Benin,BEN,0,0,0,0,1,1,2,7750003
2004,Athens,Greece,Bermuda,BER,0,0,0,0,0,2,2,63740
2004,Athens,Greece,Bosnia and Herzegovina,BIH,1,0,0,1,15,0,15,3764194
2004,Athens,Greece,Botswana,BOT,1,0,0,1,0,1,1,1765533
2004,Athens,Greece,Brazil,BRA,14,12,7,33,72,22,94,184006479
2004,Athens,Greece,Bulgaria,BUL,0,0,0,0,6,3,9,7716860
2004,Athens,Greece,Cambodia,CAM,0,0,0,0,1,1,2,13066475
2004,Athens,Greece,Canada,CAN,28,19,25,72,89,53,142,31940655
2004,Athens,Greece,Cape Verde,CPV,0,0,0,0,2,1,3,456619
2004,Athens,Greece,Central African Republic,CAF,0,0,0,0,1,0,1,3959883
2004,Athens,Greece,Chile,CHI,0,0,0,0,4,0,4,16014972
2004,Athens,Greece,People's Republic of China,CHN,63,46,32,141,108,89,197,1296075000
2004,Athens,Greece,Chinese Taipei,TPE,2,2,2,6,15,10,25,
2004,Athens,Greece,Colombia,COL,0,0,0,0,4,1,5,42075953
2004,Athens,Greece,Costa Rica,CRC,0,0,0,0,1,0,1,4225156
2004,Athens,Greece,Côte d'Ivoire,CIV,0,0,0,0,2,0,2,
2004,Athens,Greece,Croatia,CRO,0,0,4,4,12,5,17,4304600
2004,Athens,Greece,Cuba,CUB,2,2,7,11,19,5,24,11250369
2004,Athens,Greece,Cyprus,CYP,1,0,0,1,2,3,5,1010410
2004,Athens,Greece,Czech Republic,CZE,16,8,7,31,45,20,65,10197101
2004,Athens,Greece,Denmark,DEN,5,3,7,15,22,10,32,5404523
2004,Athens,Greece,Dominican Republic,DOM,0,0,0,0,1,1,2,8974444
2004,Athens,Greece,Ecuador,ECU,0,0,0,0,3,1,4,13596390
2004,Athens,Greece,Egypt,EGY,6,9,8,23,36,10,46,74172073
2004,Athens,Greece,El Salvador,ESA,0,0,0,0,1,1,2,6023801
2004,Athens,Greece,Estonia,EST,0,1,0,1,4,2,6,1362550
2004,Athens,Greece,Ethiopia,ETH,0,0,0,0,1,0,1,74239508
2004,Athens,Greece,Faroe Islands,FRO,0,0,1,1,0,1,1,47600
2004,Athens,Greece,Fiji,FIJ,0,0,0,0,1,1,2,817864
2004,Athens,Greece,Finland,FIN,4,1,3,8,31,23,54,5228172
2004,Athens,Greece,France,FRA,18,26,30,74,102,30,132,62704901
2004,Athens,Greece,Germany,GER,19,28,31,78,138,70,208,82516260
2004,Athens,Greece,Ghana,GHA,0,0,0,0,2,1,3,21272328
2004,Athens,Greece,Great Britain,GBR,35,30,29,94,99,65,164,59987905
2004,Athens,Greece,Greece,GRE,3,13,4,20,104,17,121,10955141
2004,Athens,Greece,Guatemala,GUA,0,0,0,0,1,1,2,12682108
2004,Athens,Greece,Guinea,GUY,0,0,0,0,1,0,1,8925729
2004,Athens,Greece,Honduras,HON,0,0,0,0,1,1,2,7282953
2004,Athens,Greece,"Hong Kong, China",HKG,11,7,1,19,15,9,24,6783500
2004,Athens,Greece,Hungary,HUN,1,8,10,19,25,12,37,10107146
2004,Athens,Greece,Iceland,ISL,1,3,0,4,2,1,3,292074
2004,Athens,Greece,India,IND,1,0,1,2,11,1,12,1129623466
2004,Athens,Greece,Indonesia,INA,0,0,0,0,3,0,3,223285666
2004,Athens,Greece,Islamic Republic of Iran,IRI,6,3,13,22,83,6,89,68951279
2004,Athens,Greece,Iraq,IRQ,1,0,1,2,8,0,8,26313838
2004,Athens,Greece,Ireland,IRL,0,3,1,4,32,8,40,4070262
2004,Athens,Greece,Israel,ISR,4,4,5,13,21,3,24,6809000
2004,Athens,Greece,Italy,ITA,4,8,7,19,61,14,75,57685327
2004,Athens,Greece,Jamaica,JAM,1,0,1,2,2,2,4,2725017
2004,Athens,Greece,Japan,JPN,17,15,20,52,106,54,160,127761000
2004,Athens,Greece,Jordan,JOR,0,1,1,2,5,5,10,5580241
2004,Athens,Greece,Kazakhstan,KAZ,0,0,0,0,6,2,8,15012984
2004,Athens,Greece,Kenya,KEN,3,1,3,7,8,8,16,35635267
2004,Athens,Greece,Republic of Korea,KOR,11,11,6,28,70,10,80,48082519
2004,Athens,Greece,Kuwait,KUW,1,2,3,6,13,1,14,2200498
2004,Athens,Greece,Kyrgyzstan,KGZ,0,0,0,0,3,0,3,5104700
2004,Athens,Greece,Latvia,LAT,1,1,1,3,3,4,7,2263122
2004,Athens,Greece,Lesotho,LES,0,0,0,0,1,1,2,2005953
2004,Athens,Greece,Libya,LBA,0,0,0,0,1,1,2,5710163
2004,Athens,Greece,Liechtenstein,LIE,0,0,0,0,1,0,1,34444
2004,Athens,Greece,Lithuania,LTU,1,1,5,7,16,4,20,3377075
2004,Athens,Greece,"Macao, China",MAC,0,0,0,0,1,0,1,
2004,Athens,Greece,Malaysia,MAS,0,0,0,0,15,4,19,25190647
2004,Athens,Greece,Mauritania,MTN,0,0,0,0,0,1,1,2939246
2004,Athens,Greece,Mauritius,MRI,0,0,0,0,1,1,2,1221003
2004,Athens,Greece,Mexico,MEX,14,10,10,34,36,41,77,104514934
2004,Athens,Greece,Republic of Moldova,MDA,0,0,0,0,3,0,3,2895147
2004,Athens,Greece,Mongolia,MGL,0,0,0,0,2,1,3,2496394
2004,Athens,Greece,Morocco,MAR,2,4,0,6,7,3,10,30115196
2004,Athens,Greece,Namibia,NAM,0,0,0,0,1,0,1,1907737
2004,Athens,Greece,Nepal,NEP,0,0,0,0,0,1,1,25419337
2004,Athens,Greece,Netherlands,NED,5,12,12,29,51,42,93,16281779
2004,Athens,Greece,New Zealand,NZL,6,1,3,10,28,8,36,4087500
2004,Athens,Greece,Nicaragua,NCA,0,0,0,0,1,0,1,5364930
2004,Athens,Greece,Niger,NIG,0,0,0,0,1,0,1,13125914
2004,Athens,Greece,Nigeria,NGR,5,4,3,12,6,8,14,135320420
2004,Athens,Greece,North Macedonia,MKD,0,1,0,1,2,1,3,2057044
2004,Athens,Greece,Norway,NOR,3,1,1,5,19,11,30,4591910
2004,Athens,Greece,Oman,OMA,0,0,0,0,2,0,2,2445524
2004,Athens,Greece,Pakistan,PAK,0,0,0,0,8,1,9,156664698
2004,Athens,Greece,Palestine,PLE,0,1,1,2,2,0,2,
2004,Athens,Greece,Panama,PAN,0,1,0,1,1,1,2,3269356
2004,Athens,Greece,Peru,PER,0,0,2,2,4,1,5,27624226
2004,Athens,Greece,Philippines,PHI,0,0,0,0,1,1,2,84710544
2004,Athens,Greece,Poland,POL,10,25,19,54,68,34,102,38182222
2004,Athens,Greece,Portugal,POR,2,5,5,12,22,7,29,10483861
2004,Athens,Greece,Puerto Rico,PUR,0,0,1,1,1,1,2,3826878
2004,Athens,Greece,Qatar,QAT,0,0,0,0,2,0,2,753332
2004,Athens,Greece,Romania,ROU,0,0,0,0,2,0,2,21451748
2004,Athens,Greece,Russian Federation,RUS,16,8,17,41,49,35,84,
2004,Athens,Greece,Rwanda,RWA,0,0,1,1,1,1,2,8680516
2004,Athens,Greece,Samoa,SAM,0,0,0,0,1,1,2,178597
2004,Athens,Greece,Saudi Arabia,KSA,0,0,0,0,6,0,6,23132686
2004,Athens,Greece,Senegal,SEN,0,0,0,0,1,1,2,10810086
2004,Athens,Greece,Serbia and Montenegro,SCG,0,0,2,2,5,0,5,
2004,Athens,Greece,Singapore,SGP,0,0,0,0,4,3,7,4166664
2004,Athens,Greece,Slovakia,SVK,5,3,4,12,28,8,36,5372280
2004,Athens,Greece,Slovenia,SLO,1,2,1,4,14,14,28,1997012
2004,Athens,Greece,South Africa,RSA,15,13,7,35,31,20,51,47291610
2004,Athens,Greece,Spain,ESP,20,27,24,71,118,34,152,42921895
2004,Athens,Greece,Sri Lanka,SRI,0,0,0,0,6,0,6,19387153
2004,Athens,Greece,Sudan,SUD,0,0,0,0,1,1,2,30214189
2004,Athens,Greece,Suriname,SUR,0,0,0,0,1,1,2,493680
2004,Athens,Greece,Sweden,SWE,8,7,6,21,32,9,41,8993531
2004,Athens,Greece,Switzerland,SUI,2,6,8,16,26,14,40,7389625
2004,Athens,Greece,Syrian Arab Republic,SYR,0,0,0,0,3,2,5,17827827
2004,Athens,Greece,Tajikistan,TJK,0,0,0,0,1,0,1,6662391
2004,Athens,Greece,Tanzania,TAN,0,0,0,0,1,1,2,
2004,Athens,Greece,Thailand,THA,3,6,6,15,33,10,43,64995303
2004,Athens,Greece,Tonga,TGA,0,0,0,0,0,1,1,100214
2004,Athens,Greece,Tunisia,TUN,8,7,3,18,14,8,22,10022278
2004,Athens,Greece,Turkey,TUR,1,0,1,2,8,1,9,67010930
2004,Athens,Greece,Turkmenistan,TKM,0,0,0,0,4,0,4,4703396
2004,Athens,Greece,Uganda,UGA,0,0,0,0,1,1,2,26821300
2004,Athens,Greece,Ukraine,UKR,24,12,19,55,57,31,88,47451626
2004,Athens,Greece,United Arab Emirates,UAE,1,1,2,4,10,0,10,4068577
2004,Athens,Greece,United States of America,USA,27,22,39,88,147,87,234,292805298
2004,Athens,Greece,Uruguay,URU,0,0,0,0,3,0,3,3321486
2004,Athens,Greece,Uzbekistan,UZB,0,0,0,0,1,0,1,25864350
2004,Athens,Greece,Venezuela,VEN,0,1,2,3,14,2,16,25996594
2004,Athens,Greece,Vietnam,VIE,0,0,0,0,0,4,4,83062819
2004,Athens,Greece,Zimbabwe,ZIM,1,0,0,1,1,1,2,12019911
2008,Beijing,China,Afghanistan,AFG,0,0,0,0,1,0,1,27722281
2008,Beijing,China,Algeria,ALG,4,3,8,15,21,7,28,34730604
2008,Beijing,China,Angola,ANG,0,3,0,3,5,1,6,21695636
2008,Beijing,China,Argentina,ARG,0,1,5,6,30,9,39,40080159
2008,Beijing,China,Armenia,ARM,0,0,0,0,0,1,1,2907615
2008,Beijing,China,Australia,AUS,23,29,27,79,86,70,156,21249200
2008,Beijing,China,Austria,AUT,4,1,1,6,34,4,38,8321496
2008,Beijing,China,Azerbaijan,AZE,2,3,5,10,17,1,18,8763400
2008,Beijing,China,Bahrain,BRN,0,0,0,0,2,1,3,1114645
2008,Beijing,China,Bangladesh,BAN,0,0,0,0,1,0,1,144304164
2008,Beijing,China,Barbados,BAR,0,0,0,0,1,0,1,279946
2008,Beijing,China,Belarus,BLR,5,7,1,13,19,11,30,9527985
2008,Beijing,China,Belgium,BEL,0,0,1,1,19,1,20,10709973
2008,Beijing,China,Benin,BEN,0,0,0,0,0,1,1,8696915
2008,Beijing,China,Bermuda,BER,0,0,0,0,1,0,1,65273
2008,Beijing,China,Bosnia and Herzegovina,BIH,0,1,0,1,14,1,15,3754261
2008,Beijing,China,Brazil,BRA,16,14,17,47,130,54,184,192030362
2008,Beijing,China,Bulgaria,BUL,0,1,1,2,4,4,8,7492561
2008,Beijing,China,Burkina Faso,BUR,0,0,0,0,1,0,1,14689725
2008,Beijing,China,Burundi,BDI,0,0,0,0,3,0,3,8126104
2008,Beijing,China,Cambodia,CAM,0,0,0,0,1,0,1,13883835
2008,Beijing,China,Canada,CAN,19,10,21,50,80,61,141,33247118
2008,Beijing,China,Cape Verde,CPV,0,0,0,0,0,1,1,480846
2008,Beijing,China,Central African Republic,CAF,0,0,0,0,1,0,1,4273368
2008,Beijing,China,Chile,CHI,0,0,0,0,3,1,4,16708255
2008,Beijing,China,People's Republic of China,CHN,89,70,52,211,196,135,331,1324655000
2008,Beijing,China,Chinese Taipei,TPE,1,0,1,2,10,7,17,
2008,Beijing,China,Colombia,COL,0,1,1,2,9,2,11,44254972
2008,Beijing,China,Costa Rica,CRC,0,0,0,0,2,0,2,4463123
2008,Beijing,China,Côte d'Ivoire,CIV,0,0,0,0,3,0,3,
2008,Beijing,China,Croatia,CRO,3,1,0,4,19,6,25,4309705
2008,Beijing,China,Cuba,CUB,5,3,6,14,26,5,31,11236975
2008,Beijing,China,Cyprus,CYP,1,2,1,4,3,1,4,1081568
2008,Beijing,China,Czech Republic,CZE,6,3,18,27,37,19,56,10384603
2008,Beijing,China,Denmark,DEN,3,2,4,9,22,15,37,5493621
2008,Beijing,China,Dominican Republic,DOM,0,0,0,0,1,0,1,9458079
2008,Beijing,China,Ecuador,ECU,0,0,0,0,1,1,2,14535740
2008,Beijing,China,Egypt,EGY,4,4,4,12,27,9,36,79636081
2008,Beijing,China,El Salvador,ESA,0,0,0,0,0,1,1,6131767
2008,Beijing,China,Estonia,EST,0,0,1,1,3,0,3,1337090
2008,Beijing,China,Ethiopia,ETH,0,0,0,0,2,0,2,82916236
2008,Beijing,China,Faroe Islands,FRO,0,0,0,0,0,1,1,47822
2008,Beijing,China,Fiji,FIJ,0,0,0,0,1,0,1,845356
2008,Beijing,China,Finland,FIN,2,2,2,6,25,6,31,5313399
2008,Beijing,China,France,FRA,12,21,19,52,80,39,119,64374979
2008,Beijing,China,Gabon,GAB,0,0,0,0,1,0,1,1518538
2008,Beijing,China,Georgia,GEO,0,0,0,0,1,0,1,3848449
2008,Beijing,China,Germany,GER,14,25,20,59,104,66,170,82110097
2008,Beijing,China,Ghana,GHA,0,0,0,0,1,1,2,23563832
2008,Beijing,China,Great Britain,GBR,42,29,31,102,130,75,205,61806995
2008,Beijing,China,Greece,GRE,5,9,10,24,52,15,67,11077841
2008,Beijing,China,Guatemala,GUA,0,0,0,0,1,0,1,13739299
2008,Beijing,China,Guinea,GUY,0,0,0,0,1,0,1,9738796
2008,Beijing,China,Haiti,HAI,0,0,0,0,0,1,1,9646570
2008,Beijing,China,Honduras,HON,0,0,0,0,1,0,1,7980955
2008,Beijing,China,"Hong Kong, China",HKG,5,3,3,11,10,12,22,6957800
2008,Beijing,China,Hungary,HUN,1,0,5,6,23,10,33,10038188
2008,Beijing,China,Iceland,ISL,0,0,0,0,4,1,5,317414
2008,Beijing,China,India,IND,0,0,0,0,5,0,5,1200669762
2008,Beijing,China,Indonesia,INA,0,0,0,0,2,1,3,235469755
2008,Beijing,China,Islamic Republic of Iran,IRI,5,6,3,14,68,4,72,72120608
2008,Beijing,China,Iraq,IRQ,0,1,1,2,17,2,19,28385739
2008,Beijing,China,Ireland,IRL,3,1,1,5,33,12,45,4489544
2008,Beijing,China,Israel,ISR,0,5,1,6,34,8,42,7308800
2008,Beijing,China,Italy,ITA,4,7,7,18,55,27,82,58826731
2008,Beijing,China,Jamaica,JAM,0,0,1,1,2,2,4,2781869
2008,Beijing,China,Japan,JPN,5,14,8,27,97,64,161,128063000
2008,Beijing,China,Jordan,JOR,0,2,2,4,7,5,12,6556473
2008,Beijing,China,Kazakhstan,KAZ,0,0,0,0,1,2,3,15776938
2008,Beijing,China,Kenya,KEN,5,3,1,9,10,3,13,39791984
2008,Beijing,China,Republic of Korea,KOR,10,8,13,31,57,20,77,49054708
2008,Beijing,China,Kuwait,KUW,0,0,0,0,7,1,8,2656010
2008,Beijing,China,Kyrgyzstan,KGZ,0,0,0,0,1,0,1,5318700
2008,Beijing,China,Lao People's Democratic Republic,LAO,0,0,1,1,1,0,1,6046630
2008,Beijing,China,Latvia,LAT,1,2,0,3,4,13,17,2177322
2008,Beijing,China,Lebanon,LBN,0,0,2,2,1,0,1,4764745
2008,Beijing,China,Lesotho,LES,0,0,0,0,0,1,1,1987130
2008,Beijing,China,Libya,LBA,0,0,0,0,2,1,3,6058740
2008,Beijing,China,Lithuania,LTU,0,2,0,2,12,14,26,3198231
2008,Beijing,China,Luxembourg,LUX,0,0,0,0,1,0,1,488650
2008,Beijing,China,"Macao, China",MAC,0,0,0,0,1,1,2,
2008,Beijing,China,Madagascar,MAD,0,0,0,0,1,0,1,19996476
2008,Beijing,China,Malaysia,MAS,0,0,1,1,8,3,11,27236003
2008,Beijing,China,Malta,MLT,0,0,0,0,1,0,1,409379
2008,Beijing,China,Mauritius,MRI,0,0,0,0,2,0,2,1244121
2008,Beijing,China,Mexico,MEX,10,3,7,20,30,37,67,110815272
2008,Beijing,China,Republic of Moldova,MDA,0,0,0,0,0,1,1,2867964
2008,Beijing,China,Mongolia,MGL,1,0,0,1,1,3,4,2631899
2008,Beijing,China,Montenegro,MNE,0,0,0,0,1,0,1,616969
2008,Beijing,China,Morocco,MAR,4,1,2,7,12,6,18,31536807
2008,Beijing,China,Myanmar,MYA,0,0,0,0,3,0,3,49929642
2008,Beijing,China,Namibia,NAM,0,0,1,1,1,0,1,2043382
2008,Beijing,China,Nepal,NEP,0,0,0,0,1,0,1,26666581
2008,Beijing,China,Netherlands,NED,5,10,7,22,33,46,79,16445593
2008,Beijing,China,New Zealand,NZL,5,3,4,12,20,9,29,4259800
2008,Beijing,China,Niger,NIG,0,0,0,0,1,0,1,15250913
2008,Beijing,China,Nigeria,NGR,4,4,1,9,14,9,23,150269622
2008,Beijing,China,North Macedonia,MKD,0,0,0,0,1,1,2,2067309
2008,Beijing,China,Norway,NOR,1,3,3,7,14,10,24,4768212
2008,Beijing,China,Oman,OMA,0,0,0,0,1,0,1,2750956
2008,Beijing,China,Pakistan,PAK,0,1,0,1,2,1,3,171648984
2008,Beijing,China,Palestine,PLE,0,0,0,0,2,0,2,
2008,Beijing,China,Panama,PAN,0,0,0,0,1,1,2,3516204
2008,Beijing,China,Papua New Guinea,PNG,0,1,0,1,1,1,2,6976200
2008,Beijing,China,Peru,PER,0,0,0,0,3,0,3,28562321
2008,Beijing,China,Philippines,PHI,0,0,0,0,1,2,3,90901967
2008,Beijing,China,Poland,POL,5,12,13,30,58,33,91,38125759
2008,Beijing,China,Portugal,POR,1,4,2,7,23,12,35,10558177
2008,Beijing,China,Puerto Rico,PUR,0,0,1,1,2,1,3,3760866
2008,Beijing,China,Qatar,QAT,0,0,0,0,2,0,2,1436670
2008,Beijing,China,Romania,ROU,0,1,0,1,2,2,4,20537875
2008,Beijing,China,Russian Federation,RUS,18,23,22,63,98,46,144,
2008,Beijing,China,Rwanda,RWA,0,0,0,0,1,0,1,9524532
2008,Beijing,China,Samoa,SAM,0,0,0,0,1,0,1,183270
2008,Beijing,China,Saudi Arabia,KSA,1,1,0,2,3,0,3,25888535
2008,Beijing,China,Senegal,SEN,0,0,0,0,1,1,2,12004700
2008,Beijing,China,Serbia,SRB,0,2,0,2,10,4,14,7350222
2008,Beijing,China,Singapore,SGP,1,1,2,4,2,4,6,4839396
2008,Beijing,China,Slovakia,SVK,2,3,1,6,26,9,35,5379233
2008,Beijing,China,Slovenia,SLO,0,1,2,3,14,16,30,2021316
2008,Beijing,China,South Africa,RSA,21,3,6,30,38,21,59,49779472
2008,Beijing,China,Spain,ESP,15,21,22,58,101,32,133,45954106
2008,Beijing,China,Sri Lanka,SRI,0,0,0,0,5,0,5,19983984
2008,Beijing,China,Suriname,SUR,0,0,0,0,1,0,1,517122
2008,Beijing,China,Sweden,SWE,5,3,4,12,38,25,63,9219637
2008,Beijing,China,Switzerland,SUI,3,2,6,11,18,8,26,7647675
2008,Beijing,China,Syrian Arab Republic,SYR,0,0,1,1,3,2,5,20664037
2008,Beijing,China,Tajikistan,TJK,0,0,0,0,0,1,1,7209924
2008,Beijing,China,Tanzania,TAN,0,0,0,0,1,0,1,
2008,Beijing,China,Thailand,THA,1,5,7,13,33,7,40,66530980
2008,Beijing,China,Timor-Leste,TLS,0,0,0,0,0,1,1,1055428
2008,Beijing,China,Tonga,TGA,0,0,0,0,1,0,1,103384
2008,Beijing,China,Tunisia,TUN,9,9,3,21,21,12,33,10414425
2008,Beijing,China,Turkey,TUR,1,0,1,2,8,8,16,70418612
2008,Beijing,China,Turkmenistan,TKM,0,0,0,0,1,2,3,4935765
2008,Beijing,China,Uganda,UGA,0,0,0,0,1,0,1,30431734
2008,Beijing,China,Ukraine,UKR,24,18,32,74,74,49,123,46258189
2008,Beijing,China,United Arab Emirates,UAE,0,1,0,1,6,1,7,7089486
2008,Beijing,China,United States of America,USA,36,35,28,99,120,87,207,304093966
2008,Beijing,China,Uruguay,URU,0,0,0,0,2,0,2,3340221
2008,Beijing,China,Uzbekistan,UZB,0,0,0,0,2,0,2,27302800
2008,Beijing,China,Vanuatu,VAN,0,0,0,0,1,0,1,224700
2008,Beijing,China,Venezuela,VEN,1,1,2,4,19,8,27,27635827
2008,Beijing,China,Vietnam,VIE,0,0,0,0,3,5,8,86243424
2008,Beijing,China,Zambia,ZAM,0,0,0,0,1,0,1,12848531
2008,Beijing,China,Zimbabwe,ZIM,0,0,0,0,1,1,2,12379553
2012,London,Great Britain,Afghanistan,AFG,0,0,0,0,1,0,1,31161378
2012,London,Great Britain,Albania,ALB,0,0,0,0,1,0,1,2900401
2012,London,Great Britain,Algeria,ALG,4,6,9,19,24,7,31,37383899
2012,London,Great Britain,Andorra,AND,0,0,0,0,1,0,1,82427
2012,London,Great Britain,Angola,ANG,1,0,1,2,2,2,4,25107925
2012,London,Great Britain,Antigua and Barbuda,ANT,0,0,0,0,1,0,1,90407
2012,London,Great Britain,Argentina,ARG,0,1,4,5,47,10,57,41733271
2012,London,Great Britain,Armenia,ARM,0,0,0,0,0,2,2,2884239
2012,London,Great Britain,Australia,AUS,32,23,30,85,88,70,158,22733465
2012,London,Great Britain,Austria,AUT,4,3,6,13,27,5,32,8429991
2012,London,Great Britain,Azerbaijan,AZE,4,5,3,12,16,5,21,9295784
2012,London,Great Britain,Bahrain,BRN,0,0,0,0,1,1,2,1299942
2012,London,Great Britain,Barbados,BAR,0,0,0,0,1,0,1,283698
2012,London,Great Britain,Belarus,BLR,5,2,3,10,15,14,29,9464495
2012,London,Great Britain,Belgium,BEL,3,1,3,7,31,9,40,11106932
2012,London,Great Britain,Benin,BEN,0,0,0,0,1,0,1,9729254
2012,London,Great Britain,Bermuda,BER,0,0,0,0,0,1,1,64798
2012,London,Great Britain,Bosnia and Herzegovina,BIH,1,0,0,1,11,1,12,3604972
2012,London,Great Britain,Brazil,BRA,21,14,8,43,110,68,178,199287292
2012,London,Great Britain,Brunei Darussalam,BRU,0,0,0,0,1,0,1,398997
2012,London,Great Britain,Bulgaria,BUL,0,2,1,3,4,4,8,7305888
2012,London,Great Britain,Burkina Faso,BUR,0,0,0,0,1,1,2,16571252
2012,London,Great Britain,Burundi,BDI,0,0,0,0,1,0,1,9245992
2012,London,Great Britain,Cambodia,CAM,0,0,0,0,0,1,1,14780454
2012,London,Great Britain,Cameroon,CMR,0,0,0,0,1,0,1,21485267
2012,London,Great Britain,Canada,CAN,7,15,9,31,87,57,144,34714222
2012,London,Great Britain,Cape Verde,CPV,0,0,0,0,1,0,1,505241
2012,London,Great Britain,Central African Republic,CAF,0,0,0,0,1,0,1,4436411
2012,London,Great Britain,Chile,CHI,1,0,0,1,4,3,7,17400359
2012,London,Great Britain,People's Republic of China,CHN,95,71,65,231,154,128,282,1350695000
2012,London,Great Britain,Chinese Taipei,TPE,0,1,2,3,9,9,18,
2012,London,Great Britain,Colombia,COL,0,2,0,2,30,7,37,46075721
2012,London,Great Britain,Comoros,COM,0,0,0,0,1,0,1,723865
2012,London,Great Britain,Costa Rica,CRC,0,0,0,0,2,0,2,4688003
2012,London,Great Britain,Côte d'Ivoire,CIV,0,0,0,0,3,1,4,
2012,London,Great Britain,Croatia,CRO,0,2,3,5,18,7,25,4267558
2012,London,Great Britain,Cuba,CUB,9,5,3,17,18,4,22,11257112
2012,London,Great Britain,Cyprus,CYP,0,1,0,1,2,1,3,1135046
2012,London,Great Britain,Czech Republic,CZE,1,6,4,11,31,15,46,10510785
2012,London,Great Britain,Denmark,DEN,1,0,4,5,15,13,28,5591572
2012,London,Great Britain,Djibouti,DJI,0,0,0,0,1,0,1,868136
2012,London,Great Britain,Dominican Republic,DOM,0,0,0,0,2,0,2,9930916
2012,London,Great Britain,DR Congo,COD,0,0,0,0,1,1,2,
2012,London,Great Britain,Ecuador,ECU,0,0,0,0,1,1,2,15474099
2012,London,Great Britain,Egypt,EGY,4,4,7,15,29,11,40,86422240
2012,London,Great Britain,El Salvador,ESA,0,0,0,0,1,0,1,6237922
2012,London,Great Britain,Estonia,EST,0,0,0,0,2,1,3,1322696
2012,London,Great Britain,Ethiopia,ETH,0,1,0,1,3,1,4,92726982
2012,London,Great Britain,Faroe Islands,FRO,0,0,0,0,1,0,1,47843
2012,London,Great Britain,Fiji,FIJ,1,0,0,1,1,0,1,865065
2012,London,Great Britain,Finland,FIN,4,1,1,6,21,14,35,5413971
2012,London,Great Britain,France,FRA,8,19,18,45,101,51,152,65659814
2012,London,Great Britain,Gabon,GAB,0,0,0,0,1,0,1,1749677
2012,London,Great Britain,Gambia,GAM,0,0,0,0,1,1,2,1905020
2012,London,Great Britain,Georgia,GEO,0,0,0,0,2,0,2,3728874
2012,London,Great Britain,Germany,GER,18,26,22,66,88,62,150,80425823
2012,London,Great Britain,Ghana,GHA,0,0,0,0,3,1,4,25996454
2012,London,Great Britain,Great Britain,GBR,34,43,43,120,177,109,286,63700215
2012,London,Great Britain,Greece,GRE,1,3,8,12,47,13,60,11045011
2012,London,Great Britain,Guatemala,GUA,0,0,0,0,1,0,1,14781942
2012,London,Great Britain,Guinea-Bissau,GBS,0,0,0,0,1,1,2,1604981
2012,London,Great Britain,Haiti,HAI,0,0,0,0,2,1,3,10250922
2012,London,Great Britain,Honduras,HON,0,0,0,0,1,0,1,8640692
2012,London,Great Britain,"Hong Kong, China",HKG,3,3,6,12,13,15,28,7150100
2012,London,Great Britain,Hungary,HUN,2,6,6,14,19,14,33,9920362
2012,London,Great Britain,Iceland,ISL,1,0,0,1,2,2,4,320716
2012,London,Great Britain,India,IND,0,1,0,1,10,0,10,1265780243
2012,London,Great Britain,Indonesia,INA,0,0,1,1,3,1,4,248451714
2012,London,Great Britain,Islamic Republic of Iran,IRI,10,7,7,24,70,7,77,75539881
2012,London,Great Britain,Iraq,IRQ,0,2,1,3,16,3,19,31890012
2012,London,Great Britain,Ireland,IRL,8,3,5,16,28,17,45,4599533
2012,London,Great Britain,Israel,ISR,1,2,5,8,18,7,25,7910500
2012,London,Great Britain,Italy,ITA,9,8,11,28,65,31,96,59539717
2012,London,Great Britain,Jamaica,JAM,1,0,0,1,2,1,3,2842128
2012,London,Great Britain,Japan,JPN,5,5,6,16,89,45,134,127629000
2012,London,Great Britain,Jordan,JOR,0,0,0,0,4,4,8,8089963
2012,London,Great Britain,Kazakhstan,KAZ,0,0,0,0,4,3,7,16792090
2012,London,Great Britain,Kenya,KEN,2,2,2,6,10,2,12,44343469
2012,London,Great Britain,Republic of Korea,KOR,9,9,9,27,60,28,88,50199853
2012,London,Great Britain,Korea DPR,PRK,0,0,0,0,1,0,1,
2012,London,Great Britain,Kuwait,KUW,0,0,0,0,6,0,6,3348852
2012,London,Great Britain,Kyrgyzstan,KGZ,0,0,0,0,1,0,1,5607200
2012,London,Great Britain,Lao People's Democratic Republic,LAO,0,0,0,0,1,0,1,6444527
2012,London,Great Britain,Latvia,LAT,1,1,0,2,6,2,8,2034319
2012,London,Great Britain,Lebanon,LBN,0,0,0,0,1,0,1,5537620
2012,London,Great Britain,Lesotho,LES,0,0,0,0,0,1,1,2014988
2012,London,Great Britain,Liberia,LBR,0,0,0,0,1,0,1,4135662
2012,London,Great Britain,Libya,LBA,0,0,0,0,2,0,2,6285751
2012,London,Great Britain,Lithuania,LTU,0,0,0,0,9,2,11,2987773
2012,London,Great Britain,"Macao, China",MAC,0,0,0,0,1,1,2,
2012,London,Great Britain,Madagascar,MAD,0,0,0,0,1,0,1,22346641
2012,London,Great Britain,Malaysia,MAS,0,1,1,2,16,6,22,29068189
2012,London,Great Britain,Mali,MLI,0,0,0,0,1,0,1,15979492
2012,London,Great Britain,Malta,MLT,0,0,0,0,1,0,1,420028
2012,London,Great Britain,Mauritania,MTN,0,0,0,0,1,1,2,3706555
2012,London,Great Britain,Mauritius,MRI,0,0,0,0,1,1,2,1255882
2012,London,Great Britain,Mexico,MEX,6,4,11,21,37,44,81,117274156
2012,London,Great Britain,Republic of Moldova,MDA,0,0,0,0,1,1,2,2859458
2012,London,Great Britain,Mongolia,MGL,0,0,0,0,3,3,6,2824698
2012,London,Great Britain,Montenegro,MNE,0,0,0,0,0,1,1,620601
2012,London,Great Britain,Morocco,MAR,3,0,3,6,24,6,30,33241898
2012,London,Great Britain,Mozambique,MOZ,0,0,0,0,1,1,2,24862673
2012,London,Great Britain,Myanmar,MYA,0,0,0,0,2,0,2,51413703
2012,London,Great Britain,Namibia,NAM,1,1,0,2,4,1,5,2194777
2012,London,Great Britain,Nepal,NEP,0,0,0,0,1,1,2,26989160
2012,London,Great Britain,Netherlands,NED,10,10,19,39,39,49,88,16754962
2012,London,Great Britain,New Zealand,NZL,6,7,4,17,11,12,23,4408100
2012,London,Great Britain,Nicaragua,NCA,0,0,0,0,1,1,2,5982530
2012,London,Great Britain,Niger,NIG,0,0,0,0,1,1,2,17795209
2012,London,Great Britain,Nigeria,NGR,6,5,2,13,17,12,29,167228803
2012,London,Great Britain,North Macedonia,MKD,1,0,0,1,1,1,2,2074275
2012,London,Great Britain,Norway,NOR,3,2,3,8,13,9,22,5018573
2012,London,Great Britain,Oman,OMA,0,0,0,0,2,0,2,3498031
2012,London,Great Britain,Pakistan,PAK,0,0,0,0,2,0,2,187280125
2012,London,Great Britain,Palestine,PLE,0,0,0,0,2,0,2,
2012,London,Great Britain,Panama,PAN,0,0,0,0,1,1,2,3770635
2012,London,Great Britain,Papua New Guinea,PNG,0,0,0,0,2,0,2,7631003
2012,London,Great Britain,Peru,PER,0,0,0,0,1,0,1,29506790
2012,London,Great Britain,Philippines,PHI,0,0,0,0,4,5,9,97212639
2012,London,Great Britain,Poland,POL,14,13,9,36,64,35,99,38063164
2012,London,Great Britain,Portugal,POR,0,1,2,3,22,8,30,10514844
2012,London,Great Britain,Puerto Rico,PUR,0,0,0,0,2,0,2,3634488
2012,London,Great Britain,Qatar,QAT,0,0,0,0,1,0,1,2196078
2012,London,Great Britain,Romania,ROU,1,1,0,2,4,1,5,20058035
2012,London,Great Britain,Russian Federation,RUS,36,38,28,102,120,61,181,
2012,London,Great Britain,Rwanda,RWA,0,0,0,0,14,0,14,10549668
2012,London,Great Britain,Samoa,SAM,0,0,0,0,1,1,2,189089
2012,London,Great Britain,San Marino,SMR,0,0,0,0,1,0,1,32103
2012,London,Great Britain,Saudi Arabia,KSA,0,1,0,1,4,0,4,29154906
2012,London,Great Britain,Senegal,SEN,0,0,0,0,1,0,1,13401990
2012,London,Great Britain,Serbia,SRB,2,3,0,5,9,4,13,7199077
2012,London,Great Britain,Sierra Leone,SLE,0,0,0,0,1,0,1,6712586
2012,London,Great Britain,Singapore,SGP,0,1,1,2,2,6,8,5312437
2012,London,Great Britain,Slovakia,SVK,2,1,3,6,25,8,33,5407579
2012,London,Great Britain,Slovenia,SLO,0,1,0,1,7,15,22,2057159
2012,London,Great Britain,Solomon Islands,SOL,0,0,0,0,0,1,1,556066
2012,London,Great Britain,South Africa,RSA,8,12,9,29,44,18,62,52832659
2012,London,Great Britain,Spain,ESP,8,18,16,42,98,29,127,46773055
2012,London,Great Britain,Sri Lanka,SRI,0,0,1,1,6,1,7,20425000
2012,London,Great Britain,Suriname,SUR,0,0,0,0,1,0,1,541247
2012,London,Great Britain,Sweden,SWE,4,4,4,12,40,19,59,9519374
2012,London,Great Britain,Switzerland,SUI,3,6,4,13,15,10,25,7996861
2012,London,Great Britain,Syrian Arab Republic,SYR,0,0,0,0,3,2,5,20438861
2012,London,Great Britain,Tajikistan,TJK,0,0,0,0,1,0,1,7874838
2012,London,Great Britain,Tanzania,TAN,0,0,0,0,1,0,1,
2012,London,Great Britain,Thailand,THA,4,2,2,8,38,11,49,67835969
2012,London,Great Britain,Timor-Leste,TLS,0,0,0,0,1,0,1,1133002
2012,London,Great Britain,Tonga,TGA,0,0,0,0,1,0,1,102736
2012,London,Great Britain,Trinidad and Tobago,TTO,0,0,0,0,1,1,2,1344814
2012,London,Great Britain,Tunisia,TUN,9,5,5,19,18,13,31,10846993
2012,London,Great Britain,Turkey,TUR,1,5,4,10,46,21,67,74651046
2012,London,Great Britain,Turkmenistan,TKM,0,0,0,0,3,2,5,5267906
2012,London,Great Britain,US Virgin Islands,ISV,0,0,0,0,0,1,1,108188
2012,London,Great Britain,Uganda,UGA,0,0,0,0,1,1,2,34558700
2012,London,Great Britain,Ukraine,UKR,32,24,28,84,83,65,148,45593342
2012,London,Great Britain,United Arab Emirates,UAE,1,1,1,3,11,4,15,9141598
2012,London,Great Britain,United States of America,USA,31,29,38,98,128,93,221,313877662
2012,London,Great Britain,Uruguay,URU,0,0,0,0,1,0,1,3378975
2012,London,Great Britain,Uzbekistan,UZB,0,1,0,1,8,2,10,29774500
2012,London,Great Britain,Vanuatu,VAN,0,0,0,0,1,0,1,249505
2012,London,Great Britain,Venezuela,VEN,0,0,2,2,21,6,27,29360827
2012,London,Great Britain,Vietnam,VIE,0,0,0,0,6,5,11,89801926
2012,London,Great Britain,Zambia,ZAM,0,0,0,0,1,1,2,14465148
2012,London,Great Britain,Zimbabwe,ZIM,0,0,0,0,2,0,2,13115149
2016,Rio de Janeiro,Brazil,Afghanistan,AFG,0,0,0,0,1,0,1,35383028
2016,Rio de Janeiro,Brazil,Algeria,ALG,4,5,7,16,34,26,60,40551398
2016,Rio de Janeiro,Brazil,Angola,ANG,0,0,0,0,2,2,4,28842482
2016,Rio de Janeiro,Brazil,Argentina,ARG,1,1,3,5,56,26,82,43590368
2016,Rio de Janeiro,Brazil,Armenia,ARM,0,0,0,0,0,2,2,2936147
2016,Rio de Janeiro,Brazil,Aruba,ARU,0,0,0,0,1,0,1,104865
2016,Rio de Janeiro,Brazil,Australia,AUS,22,30,29,81,101,69,170,24190907
2016,Rio de Janeiro,Brazil,Austria,AUT,1,4,4,9,21,6,27,8736668
2016,Rio de Janeiro,Brazil,Azerbaijan,AZE,1,8,2,11,18,5,23,9757812
2016,Rio de Janeiro,Brazil,Bahrain,BRN,1,0,0,1,0,2,2,1425793
2016,Rio de Janeiro,Brazil,Belarus,BLR,8,0,2,10,10,10,20,9501534
2016,Rio de Janeiro,Brazil,Belgium,BEL,5,3,3,11,19,10,29,11331422
2016,Rio de Janeiro,Brazil,Benin,BEN,0,0,0,0,1,0,1,10872072
2016,Rio de Janeiro,Brazil,Bermuda,BER,0,0,0,0,0,2,2,64554
2016,Rio de Janeiro,Brazil,Bosnia and Herzegovina,BIH,0,1,0,1,13,1,14,3386263
2016,Rio de Janeiro,Brazil,Botswana,BOT,0,0,0,0,1,0,1,2159925
2016,Rio de Janeiro,Brazil,Brazil,BRA,14,29,29,72,184,102,286,206163056
2016,Rio de Janeiro,Brazil,Bulgaria,BUL,1,0,0,1,4,3,7,7127822
2016,Rio de Janeiro,Brazil,Burkina Faso,BUR,0,0,0,0,1,0,1,18646350
2016,Rio de Janeiro,Brazil,Burundi,BDI,0,0,0,0,1,0,1,10488002
2016,Rio de Janeiro,Brazil,Cambodia,CAM,0,0,0,0,1,0,1,15766290
2016,Rio de Janeiro,Brazil,Cameroon,CMR,0,0,0,0,1,0,1,23926549
2016,Rio de Janeiro,Brazil,Canada,CAN,8,10,11,29,80,73,153,36109487
2016,Rio de Janeiro,Brazil,Cape Verde,CPV,0,0,1,1,2,0,2,531140
2016,Rio de Janeiro,Brazil,Central African Republic,CAF,0,0,0,0,1,0,1,4537683
2016,Rio de Janeiro,Brazil,Chile,CHI,0,0,0,0,7,8,15,18209072
2016,Rio de Janeiro,Brazil,People's Republic of China,CHN,107,81,51,239,161,146,307,1378665000
2016,Rio de Janeiro,Brazil,Chinese Taipei,TPE,0,1,1,2,5,8,13,
2016,Rio de Janeiro,Brazil,Colombia,COL,2,5,10,17,26,13,39,48175048
2016,Rio de Janeiro,Brazil,Congo,CGO,0,0,0,0,1,0,1,4980996
2016,Rio de Janeiro,Brazil,Costa Rica,CRC,0,0,0,0,2,1,3,4899336
2016,Rio de Janeiro,Brazil,Côte d'Ivoire,CIV,0,1,0,1,3,2,5,
2016,Rio de Janeiro,Brazil,Croatia,CRO,2,2,1,5,12,7,19,4174349
2016,Rio de Janeiro,Brazil,Cuba,CUB,8,1,6,15,16,6,22,11335108
2016,Rio de Janeiro,Brazil,Cyprus,CYP,0,0,0,0,1,1,2,1170189
2016,Rio de Janeiro,Brazil,Czech Republic,CZE,1,2,4,7,23,14,37,10566332
2016,Rio de Janeiro,Brazil,Denmark,DEN,1,2,4,7,13,8,21,5728010
2016,Rio de Janeiro,Brazil,Dominican Republic,DOM,0,0,0,0,2,0,2,10397738
2016,Rio de Janeiro,Brazil,DR Congo,COD,0,0,0,0,1,1,2,
2016,Rio de Janeiro,Brazil,Ecuador,ECU,0,0,0,0,4,1,5,16491116
2016,Rio de Janeiro,Brazil,Egypt,EGY,3,5,4,12,34,11,45,94447071
2016,Rio de Janeiro,Brazil,El Salvador,ESA,0,0,0,0,1,0,1,6356137
2016,Rio de Janeiro,Brazil,Estonia,EST,0,0,0,0,2,4,6,1315790
2016,Rio de Janeiro,Brazil,Ethiopia,ETH,0,1,0,1,4,1,5,103603461
2016,Rio de Janeiro,Brazil,Faroe Islands,FRO,0,0,0,0,0,1,1,48173
2016,Rio de Janeiro,Brazil,Fiji,FIJ,0,0,0,0,1,1,2,872406
2016,Rio de Janeiro,Brazil,Finland,FIN,1,1,1,3,19,7,26,5495303
2016,Rio de Janeiro,Brazil,France,FRA,9,5,14,28,80,42,122,66724104
2016,Rio de Janeiro,Brazil,Gabon,GAB,0,0,0,0,1,0,1,2007882
2016,Rio de Janeiro,Brazil,Gambia,GAM,0,0,0,0,1,0,1,2149134
2016,Rio de Janeiro,Brazil,Georgia,GEO,1,0,0,1,3,2,5,3727505
2016,Rio de Janeiro,Brazil,Germany,GER,18,25,14,57,89,66,155,82348669
2016,Rio de Janeiro,Brazil,Ghana,GHA,0,0,0,0,3,0,3,28481947
2016,Rio de Janeiro,Brazil,Great Britain,GBR,64,39,44,147,151,100,251,65611593
2016,Rio de Janeiro,Brazil,Greece,GRE,5,4,4,13,44,16,60,10775971
2016,Rio de Janeiro,Brazil,Guatemala,GUA,0,0,0,0,1,0,1,15827690
2016,Rio de Janeiro,Brazil,Guinea,GUY,0,0,0,0,1,0,1,11738434
2016,Rio de Janeiro,Brazil,Guinea-Bissau,GBS,0,0,0,0,1,0,1,1782434
2016,Rio de Janeiro,Brazil,Haiti,HAI,0,0,0,0,1,0,1,10839976
2016,Rio de Janeiro,Brazil,Honduras,HON,0,0,0,0,2,0,2,9270794
2016,Rio de Janeiro,Brazil,"Hong Kong, China",HKG,2,2,2,6,9,15,24,7336600
2016,Rio de Janeiro,Brazil,Hungary,HUN,1,8,9,18,19,24,43,9814023
2016,Rio de Janeiro,Brazil,Iceland,ISL,0,0,0,0,3,2,5,335439
2016,Rio de Janeiro,Brazil,India,IND,2,1,1,4,16,3,19,1324517250
2016,Rio de Janeiro,Brazil,Individual Paralympic Athletes,IPA,0,0,0,0,2,0,2,
2016,Rio de Janeiro,Brazil,Indonesia,INA,0,0,1,1,6,3,9,261556386
2016,Rio de Janeiro,Brazil,Islamic Republic of Iran,IRI,8,9,7,24,85,23,108,79563991
2016,Rio de Janeiro,Brazil,Iraq,IRQ,2,3,0,5,12,2,14,36610632
2016,Rio de Janeiro,Brazil,Ireland,IRL,4,4,3,11,30,14,44,4755335
2016,Rio de Janeiro,Brazil,Israel,ISR,0,0,3,3,17,16,33,8546000
2016,Rio de Janeiro,Brazil,Italy,ITA,10,14,15,39,60,40,100,60627498
2016,Rio de Janeiro,Brazil,Jamaica,JAM,0,0,0,0,2,1,3,2906242
2016,Rio de Janeiro,Brazil,Japan,JPN,0,10,14,24,86,46,132,126994511
2016,Rio de Janeiro,Brazil,Jordan,JOR,0,2,1,3,7,3,10,9554286
2016,Rio de Janeiro,Brazil,Kazakhstan,KAZ,1,1,0,2,7,4,11,17794055
2016,Rio de Janeiro,Brazil,Kenya,KEN,3,1,2,6,7,2,9,49051531
2016,Rio de Janeiro,Brazil,Republic of Korea,KOR,7,11,17,35,53,29,82,51217803
2016,Rio de Janeiro,Brazil,Korea DPR,PRK,0,0,0,0,1,1,2,
2016,Rio de Janeiro,Brazil,Kuwait,KUW,1,0,0,1,6,0,6,3956862
2016,Rio de Janeiro,Brazil,Kyrgyzstan,KGZ,0,0,0,0,3,0,3,6079500
2016,Rio de Janeiro,Brazil,Lao People's Democratic Republic,LAO,0,0,0,0,1,0,1,6845848
2016,Rio de Janeiro,Brazil,Latvia,LAT,2,0,2,4,6,5,11,1959537
2016,Rio de Janeiro,Brazil,Lesotho,LES,0,0,0,0,1,1,2,2075041
2016,Rio de Janeiro,Brazil,Libya,LBA,0,0,0,0,1,2,3,6492160
2016,Rio de Janeiro,Brazil,Lithuania,LTU,2,1,0,3,12,1,13,2868231
2016,Rio de Janeiro,Brazil,Luxembourg,LUX,0,0,0,0,3,0,3,582014
2016,Rio de Janeiro,Brazil,"Macao, China",MAC,0,0,0,0,1,0,1,
2016,Rio de Janeiro,Brazil,Madagascar,MAD,0,0,0,0,1,0,1,24894370
2016,Rio de Janeiro,Brazil,Malawi,MAW,0,0,0,0,0,1,1,17205253
2016,Rio de Janeiro,Brazil,Malaysia,MAS,3,0,1,4,17,2,19,30684652
2016,Rio de Janeiro,Brazil,Mali,MLI,0,0,0,0,1,1,2,17965448
2016,Rio de Janeiro,Brazil,Malta,MLT,0,0,0,0,0,1,1,455356
2016,Rio de Janeiro,Brazil,Mauritius,MRI,0,0,0,0,1,1,2,1263473
2016,Rio de Janeiro,Brazil,Mexico,MEX,4,2,9,15,37,32,69,123333379
2016,Rio de Janeiro,Brazil,Republic of Moldova,MDA,0,0,0,0,1,2,3,2802170
2016,Rio de Janeiro,Brazil,Mongolia,MGL,0,0,2,2,6,2,8,3056358
2016,Rio de Janeiro,Brazil,Montenegro,MNE,0,0,0,0,1,1,2,622303
2016,Rio de Janeiro,Brazil,Morocco,MAR,3,2,2,7,18,6,24,35126274
2016,Rio de Janeiro,Brazil,Mozambique,MOZ,0,0,1,1,0,1,1,27829930
2016,Rio de Janeiro,Brazil,Myanmar,MYA,0,0,0,0,2,0,2,53045199
2016,Rio de Janeiro,Brazil,Namibia,NAM,1,2,2,5,7,2,9,2358044
2016,Rio de Janeiro,Brazil,Nepal,NEP,0,0,0,0,1,1,2,27263430
2016,Rio de Janeiro,Brazil,Netherlands,NED,17,19,26,62,58,62,120,17030314
2016,Rio de Janeiro,Brazil,New Zealand,NZL,9,5,7,21,17,12,29,4714100
2016,Rio de Janeiro,Brazil,Nicaragua,NCA,0,0,0,0,2,1,3,6303970
2016,Rio de Janeiro,Brazil,Niger,NIG,0,0,0,0,1,1,2,20788789
2016,Rio de Janeiro,Brazil,Nigeria,NGR,8,2,2,12,9,13,22,185960244
2016,Rio de Janeiro,Brazil,North Macedonia,MKD,0,0,0,0,1,1,2,2080746
2016,Rio de Janeiro,Brazil,Norway,NOR,3,2,3,8,12,13,25,5234519
2016,Rio de Janeiro,Brazil,Oman,OMA,0,0,0,0,1,1,2,4479217
2016,Rio de Janeiro,Brazil,Pakistan,PAK,0,0,1,1,1,0,1,203631356
2016,Rio de Janeiro,Brazil,Palestine,PLE,0,0,0,0,1,0,1,
2016,Rio de Janeiro,Brazil,Panama,PAN,0,0,0,0,1,1,2,4037073
2016,Rio de Janeiro,Brazil,Papua New Guinea,PNG,0,0,0,0,1,1,2,8271766
2016,Rio de Janeiro,Brazil,Peru,PER,0,0,0,0,5,1,6,30926036
2016,Rio de Janeiro,Brazil,Philippines,PHI,0,0,1,1,3,2,5,103663812
2016,Rio de Janeiro,Brazil,Poland,POL,9,18,12,39,54,36,90,37970087
2016,Rio de Janeiro,Brazil,Portugal,POR,0,0,4,4,25,12,37,10325452
2016,Rio de Janeiro,Brazil,Puerto Rico,PUR,0,0,0,0,3,1,4,3406672
2016,Rio de Janeiro,Brazil,Qatar,QAT,0,2,0,2,2,1,3,2654379
2016,Rio de Janeiro,Brazil,Romania,ROU,0,0,1,1,9,3,12,19702267
2016,Rio de Janeiro,Brazil,Rwanda,RWA,0,0,0,0,1,12,13,11668829
2016,Rio de Janeiro,Brazil,Samoa,SAM,0,0,0,0,1,1,2,194540
2016,Rio de Janeiro,Brazil,Sao Tome and Principe,STP,0,0,0,0,1,0,1,203221
2016,Rio de Janeiro,Brazil,Saudi Arabia,KSA,0,0,1,1,3,0,3,32443443
2016,Rio de Janeiro,Brazil,Senegal,SEN,0,0,0,0,1,1,2,14993514
2016,Rio de Janeiro,Brazil,Serbia,SRB,3,2,4,9,13,3,16,7058322
2016,Rio de Janeiro,Brazil,Seychelles,SEY,0,0,0,0,1,0,1,94677
2016,Rio de Janeiro,Brazil,Sierra Leone,SLE,0,0,0,0,1,0,1,7328846
2016,Rio de Janeiro,Brazil,Singapore,SGP,2,0,1,3,4,9,13,5607283
2016,Rio de Janeiro,Brazil,Slovakia,SVK,5,3,3,11,21,7,28,5430798
2016,Rio de Janeiro,Brazil,Slovenia,SLO,1,1,0,2,7,1,8,2065042
2016,Rio de Janeiro,Brazil,Somalia,SOM,0,0,0,0,1,0,1,14185635
2016,Rio de Janeiro,Brazil,South Africa,RSA,7,6,4,17,26,18,44,56207649
2016,Rio de Janeiro,Brazil,Spain,ESP,9,14,8,31,83,28,111,46484062
2016,Rio de Janeiro,Brazil,Sri Lanka,SRI,0,0,1,1,8,1,9,21203000
2016,Rio de Janeiro,Brazil,Suriname,SUR,0,0,0,0,1,0,1,564883
2016,Rio de Janeiro,Brazil,Sweden,SWE,1,4,5,10,39,18,57,9923085
2016,Rio de Janeiro,Brazil,Switzerland,SUI,2,2,1,5,14,10,24,8373338
2016,Rio de Janeiro,Brazil,Syrian Arab Republic,SYR,0,0,0,0,1,1,2,17465567
2016,Rio de Janeiro,Brazil,Tajikistan,TJK,0,0,0,0,1,0,1,8663575
2016,Rio de Janeiro,Brazil,Tanzania,TAN,0,0,0,0,1,0,1,
2016,Rio de Janeiro,Brazil,Thailand,THA,6,6,6,18,30,15,45,68971313
2016,Rio de Janeiro,Brazil,Timor-Leste,TLS,0,0,0,0,1,1,2,1219289
2016,Rio de Janeiro,Brazil,Togo,TOG,0,0,0,0,1,0,1,7509952
2016,Rio de Janeiro,Brazil,Tonga,TGA,0,0,0,0,1,1,2,101143
2016,Rio de Janeiro,Brazil,Trinidad and Tobago,TTO,1,1,1,3,1,2,3,1377563
2016,Rio de Janeiro,Brazil,Tunisia,TUN,7,6,6,19,14,17,31,11303942
2016,Rio de Janeiro,Brazil,Turkey,TUR,3,1,5,9,46,32,78,79827868
2016,Rio de Janeiro,Brazil,Turkmenistan,TKM,0,0,0,0,1,1,2,5662371
2016,Rio de Janeiro,Brazil,US Virgin Islands,ISV,0,0,0,0,1,0,1,107516
2016,Rio de Janeiro,Brazil,Uganda,UGA,0,1,0,1,1,0,1,39649173
2016,Rio de Janeiro,Brazil,Ukraine,UKR,41,37,39,117,91,77,168,45004673
2016,Rio de Janeiro,Brazil,United Arab Emirates,UAE,2,4,1,7,12,6,18,9360975
2016,Rio de Janeiro,Brazil,United States of America,USA,40,44,31,115,154,124,278,323071755
2016,Rio de Janeiro,Brazil,Uruguay,URU,0,0,0,0,3,1,4,3424139
2016,Rio de Janeiro,Brazil,Uzbekistan,UZB,8,6,17,31,22,10,32,31847900
2016,Rio de Janeiro,Brazil,Venezuela,VEN,0,3,3,6,16,8,24,29851249
2016,Rio de Janeiro,Brazil,Vietnam,VIE,1,1,2,4,7,4,11,93640435
2016,Rio de Janeiro,Brazil,Zimbabwe,ZIM,0,0,0,0,2,3,5,14030338
2020,Tokyo,Japan,Afghanistan,AFG,0,0,0,0,1,1,2,38928341
2020,Tokyo,Japan,Algeria,ALG,4,4,4,12,35,21,56,43851043
2020,Tokyo,Japan,Angola,ANG,0,0,0,0,1,1,2,32866268
2020,Tokyo,Japan,Argentina,ARG,0,5,4,9,40,19,59,45376763
2020,Tokyo,Japan,Armenia,ARM,0,0,0,0,1,0,1,2963234
2020,Tokyo,Japan,Aruba,ARU,0,0,0,0,1,0,1,106766
2020,Tokyo,Japan,Australia,AUS,21,29,30,80,101,80,181,25687041
2020,Tokyo,Japan,Austria,AUT,1,5,3,9,18,7,25,8917205
2020,Tokyo,Japan,Azerbaijan,AZE,14,1,4,19,24,12,36,10110116
2020,Tokyo,Japan,Bahrain,BRN,0,0,0,0,1,1,2,1701583
2020,Tokyo,Japan,Barbados,BAR,0,0,0,0,1,0,1,287371
2020,Tokyo,Japan,Belarus,BLR,5,1,1,7,12,7,19,9398861
2020,Tokyo,Japan,Belgium,BEL,4,3,8,15,25,9,34,11555997
2020,Tokyo,Japan,Benin,BEN,0,0,0,0,1,1,2,12123198
2020,Tokyo,Japan,Bermuda,BER,0,0,0,0,0,1,1,63903
2020,Tokyo,Japan,Bhutan,BHU,0,0,0,0,2,1,3,771612
2020,Tokyo,Japan,Bosnia and Herzegovina,BIH,0,0,1,1,14,1,15,3280815
2020,Tokyo,Japan,Botswana,BOT,0,0,0,0,1,1,2,2351625
2020,Tokyo,Japan,Brazil,BRA,22,20,30,72,145,96,241,212559409
2020,Tokyo,Japan,Bulgaria,BUL,0,2,0,2,2,2,4,6927288
2020,Tokyo,Japan,Burkina Faso,BUR,0,0,0,0,1,1,2,20903278
2020,Tokyo,Japan,Burundi,BDI,0,0,0,0,1,1,2,11890781
2020,Tokyo,Japan,Cambodia,CAM,0,0,0,0,1,0,1,16718971
2020,Tokyo,Japan,Cameroon,CMR,0,0,0,0,1,2,3,26545864
2020,Tokyo,Japan,Canada,CAN,5,10,6,21,57,72,129,38005238
2020,Tokyo,Japan,Cape Verde,CPV,0,0,0,0,1,1,2,555988
2020,Tokyo,Japan,Central African Republic,CAF,0,0,0,0,0,1,1,4829764
2020,Tokyo,Japan,Chile,CHI,2,3,1,6,10,9,19,19116209
2020,Tokyo,Japan,Chinese Taipei,TPE,0,0,1,1,4,6,10,
2020,Tokyo,Japan,Colombia,COL,3,7,14,24,44,22,66,50882884
2020,Tokyo,Japan,Congo,CGO,0,0,0,0,1,1,2,5518092
2020,Tokyo,Japan,Costa Rica,CRC,1,1,0,2,7,2,9,5094114
2020,Tokyo,Japan,Côte d'Ivoire,CIV,0,0,0,0,2,1,3,
2020,Tokyo,Japan,Croatia,CRO,0,3,4,7,16,6,22,4047200
2020,Tokyo,Japan,Cuba,CUB,4,1,1,6,13,4,17,11326616
2020,Tokyo,Japan,Cyprus,CYP,1,0,1,2,1,2,3,1207361
2020,Tokyo,Japan,Czech Republic,CZE,2,3,3,8,19,10,29,10698896
2020,Tokyo,Japan,Democratic Republic of the Congo,COD,0,0,0,0,1,1,2,89561404
2020,Tokyo,Japan,Denmark,DEN,3,1,1,5,16,9,25,5831404
2020,Tokyo,Japan,Dominican Republic,DOM,0,0,0,0,3,2,5,10847904
2020,Tokyo,Japan,Ecuador,ECU,1,0,2,3,5,3,8,17643060
2020,Tokyo,Japan,Egypt,EGY,0,5,2,7,29,20,49,102334403
2020,Tokyo,Japan,El Salvador,ESA,0,0,1,1,2,1,3,6486201
2020,Tokyo,Japan,Estonia,EST,0,0,0,0,4,1,5,1331057
2020,Tokyo,Japan,Ethiopia,ETH,1,0,0,1,2,1,3,114963583
2020,Tokyo,Japan,Faroe Islands,FRO,0,0,0,0,1,0,1,48865
2020,Tokyo,Japan,Fiji,FIJ,0,0,0,0,2,0,2,896444
2020,Tokyo,Japan,Finland,FIN,1,3,1,5,11,5,16,5530719
2020,Tokyo,Japan,France,FRA,11,15,28,54,108,38,146,67391582
2020,Tokyo,Japan,Gabon,GAB,0,0,0,0,1,1,2,2225728
2020,Tokyo,Japan,Gambia,GAM,0,0,0,0,1,1,2,2416664
2020,Tokyo,Japan,Georgia,GEO,0,3,0,3,9,4,13,3714000
2020,Tokyo,Japan,Germany,GER,13,12,18,43,79,58,137,83240525
2020,Tokyo,Japan,Ghana,GHA,0,0,0,0,3,0,3,31072945
2020,Tokyo,Japan,Great Britain,GBR,41,38,45,124,124,97,221,67215293
2020,Tokyo,Japan,Greece,GRE,1,3,7,11,34,11,45,10715549
2020,Tokyo,Japan,Grenada,GRN,0,0,0,0,0,2,2,112519
2020,Tokyo,Japan,Guatemala,GUA,0,0,0,0,1,1,2,16858333
2020,Tokyo,Japan,Guinea,GUI,0,0,0,0,1,1,2,13132792
2020,Tokyo,Japan,Guinea-Bissau,GBS,0,0,0,0,1,0,1,1967998
2020,Tokyo,Japan,Guyana,GUY,0,0,0,0,1,0,1,786559
2020,Tokyo,Japan,Haiti,HAI,0,0,0,0,1,0,1,11402533
2020,Tokyo,Japan,Honduras,HON,0,0,0,0,1,0,1,9904608
2020,Tokyo,Japan,"Hong Kong, China",HKG,0,2,3,5,9,14,23,7481800
2020,Tokyo,Japan,Hungary,HUN,7,5,4,16,19,20,39,9749763
2020,Tokyo,Japan,Iceland,ISL,0,0,0,0,3,3,6,366425
2020,Tokyo,Japan,India,IND,5,8,6,19,40,14,54,1380004385
2020,Tokyo,Japan,Indonesia,INA,2,3,4,9,14,9,23,273523621
2020,Tokyo,Japan,Iraq,IRQ,0,1,2,3,14,5,19,40222503
2020,Tokyo,Japan,Ireland,IRL,4,2,1,7,15,16,31,4994724
2020,Tokyo,Japan,Islamic Republic of Iran,IRI,12,11,1,24,54,9,63,83992953
2020,Tokyo,Japan,Israel,ISR,6,2,1,9,15,18,33,9216900
2020,Tokyo,Japan,Italy,ITA,14,29,26,69,52,62,114,59554023
2020,Tokyo,Japan,Jamaica,JAM,0,0,0,0,2,2,4,2961161
2020,Tokyo,Japan,Japan,JPN,13,15,23,51,153,109,262,125836021
2020,Tokyo,Japan,Jordan,JOR,4,0,1,5,6,4,10,10203140
2020,Tokyo,Japan,Kazakhstan,KAZ,1,3,1,5,16,10,26,18754440
2020,Tokyo,Japan,Kenya,KEN,0,0,1,1,4,5,9,53771300
2020,Tokyo,Japan,Kuwait,KUW,0,1,1,2,2,1,3,4270563
2020,Tokyo,Japan,Kyrgyzstan,KGZ,0,0,0,0,1,1,2,6591600
2020,Tokyo,Japan,Lao People's Democratic Republic,LAO,0,0,0,0,1,0,1,7275556
2020,Tokyo,Japan,Latvia,LAT,0,3,2,5,4,3,7,1901548
2020,Tokyo,Japan,Lebanon,LBN,0,0,0,0,1,0,1,6825442
2020,Tokyo,Japan,Lesotho,LES,0,0,0,0,0,1,1,2142252
2020,Tokyo,Japan,Liberia,LBR,0,0,0,0,1,1,2,5057677
2020,Tokyo,Japan,Libya,LBA,0,0,0,0,2,0,2,6871287
2020,Tokyo,Japan,Lithuania,LTU,0,0,3,3,10,1,11,2794700
2020,Tokyo,Japan,Luxembourg,LUX,0,0,0,0,1,0,1,632275
2020,Tokyo,Japan,Madagascar,MAD,0,0,0,0,0,1,1,27691019
2020,Tokyo,Japan,Malawi,MAW,0,0,0,0,0,1,1,19129955
2020,Tokyo,Japan,Malaysia,MAS,3,2,0,5,21,4,25,32365998
2020,Tokyo,Japan,Maldives,MDV,0,0,0,0,1,1,2,540542
2020,Tokyo,Japan,Mali,MLI,0,0,0,0,1,1,2,20250834
2020,Tokyo,Japan,Malta,MLT,0,0,0,0,1,1,2,525285
2020,Tokyo,Japan,Mauritius,MRI,0,0,0,0,1,3,4,1265740
2020,Tokyo,Japan,Mexico,MEX,7,2,13,22,31,29,60,128932753
2020,Tokyo,Japan,Mongolia,MGL,1,0,0,1,7,4,11,3278292
2020,Tokyo,Japan,Montenegro,MNE,0,0,1,1,4,1,5,621718
2020,Tokyo,Japan,Morocco,MAR,4,4,3,11,23,13,36,36910558
2020,Tokyo,Japan,Mozambique,MOZ,0,0,0,0,1,1,2,31255435
2020,Tokyo,Japan,Namibia,NAM,0,1,1,2,2,1,3,2540916
2020,Tokyo,Japan,Nepal,NEP,0,0,0,0,0,1,1,29136808
2020,Tokyo,Japan,Netherlands,NED,25,17,17,59,33,41,74,17441139
2020,Tokyo,Japan,New Zealand,NZL,6,3,3,12,16,16,32,5084300
2020,Tokyo,Japan,Nicaragua,NCA,0,0,0,0,1,1,2,6624554
2020,Tokyo,Japan,Niger,NIG,0,0,0,0,1,1,2,24206636
2020,Tokyo,Japan,Nigeria,NGR,4,1,5,10,10,12,22,206139587
2020,Tokyo,Japan,North Macedonia,MKD,0,0,0,0,0,1,1,2083380
2020,Tokyo,Japan,Norway,NOR,2,0,2,4,5,10,15,5379475
2020,Tokyo,Japan,Oman,OMA,0,0,1,1,2,1,3,5106622
2020,Tokyo,Japan,Pakistan,PAK,1,0,0,1,1,1,2,220892331
2020,Tokyo,Japan,Palestine,PLE,0,0,0,0,1,0,1,
2020,Tokyo,Japan,Panama,PAN,0,0,0,0,2,1,3,4314768
2020,Tokyo,Japan,Papua New Guinea,PNG,0,0,0,0,1,1,2,8947027
2020,Tokyo,Japan,Paraguay,PAR,0,0,0,0,1,1,2,7132530
2020,Tokyo,Japan,People's Republic of China,CHN,96,60,51,207,120,136,256,1402112000
2020,Tokyo,Japan,Peru,PER,1,0,0,1,7,4,11,32971846
2020,Tokyo,Japan,Philippines,PHI,0,0,0,0,4,0,4,109581085
2020,Tokyo,Japan,Poland,POL,7,6,12,25,55,36,91,37950802
2020,Tokyo,Japan,Portugal,POR,0,0,2,2,24,10,34,10305564
2020,Tokyo,Japan,Puerto Rico,PUR,0,0,0,0,2,1,3,3194034
2020,Tokyo,Japan,Qatar,QAT,0,0,1,1,1,1,2,2881060
2020,Tokyo,Japan,Refugee Paralympic Team,RPT,0,0,0,0,5,1,6,
2020,Tokyo,Japan,Republic of Korea,KOR,2,10,12,24,57,28,85,51780579
2020,Tokyo,Japan,Republic of Moldova,MDA,0,0,0,0,4,2,6,2617820
2020,Tokyo,Japan,Romania,ROU,0,1,1,2,8,1,9,19286123
2020,Tokyo,Japan,RPC,RPC,36,33,49,118,134,114,248,144104080
2020,Tokyo,Japan,Rwanda,RWA,0,0,0,0,1,13,14,12952209
2020,Tokyo,Japan,Sao Tome and Principe,STP,0,0,0,0,1,0,1,219161
2020,Tokyo,Japan,Saudi Arabia,KSA,0,0,1,1,5,2,7,34813867
2020,Tokyo,Japan,Senegal,SEN,0,0,0,0,2,1,3,16743930
2020,Tokyo,Japan,Serbia,SRB,2,3,1,6,13,7,20,6908224
2020,Tokyo,Japan,Sierra Leone,SLE,0,0,0,0,1,1,2,7976985
2020,Tokyo,Japan,Singapore,SGP,2,0,0,2,5,6,11,5685807
2020,Tokyo,Japan,Slovakia,SVK,5,2,4,11,21,7,28,5458827
2020,Tokyo,Japan,Slovenia,SLO,0,1,1,2,7,0,7,2100126
2020,Tokyo,Japan,Somalia,SOM,0,0,0,0,1,0,1,15893219
2020,Tokyo,Japan,South Africa,RSA,4,1,2,7,20,14,34,59308690
2020,Tokyo,Japan,Spain,ESP,9,15,12,36,93,44,137,47351567
2020,Tokyo,Japan,Sri Lanka,SRI,1,0,1,2,8,1,9,21919000
2020,Tokyo,Japan,St Vincent and the Grenadines,VIN,0,0,0,0,1,0,1,110947
2020,Tokyo,Japan,Sweden,SWE,1,5,2,8,12,17,29,10353442
2020,Tokyo,Japan,Switzerland,SUI,7,4,3,14,8,13,21,8636896
2020,Tokyo,Japan,Syrian Arab Republic,SYR,0,0,0,0,1,2,3,17500657
2020,Tokyo,Japan,Tajikistan,TJK,0,0,0,0,1,0,1,9537642
2020,Tokyo,Japan,Thailand,THA,5,5,8,18,50,26,76,69799978
2020,Tokyo,Japan,Togo,TOG,0,0,0,0,0,1,1,8278737
2020,Tokyo,Japan,Tunisia,TUN,4,5,2,11,12,13,25,11818618
2020,Tokyo,Japan,Turkey,TUR,2,4,9,15,43,44,87,84339067
2020,Tokyo,Japan,Uganda,UGA,0,0,1,1,1,3,4,45741000
2020,Tokyo,Japan,Ukraine,UKR,24,47,27,98,80,59,139,44134693
2020,Tokyo,Japan,United Arab Emirates,UAE,1,1,1,3,7,5,12,9890400
2020,Tokyo,Japan,United Republic of Tanzania,TAN,0,0,0,0,1,1,2,59734213
2020,Tokyo,Japan,United States of America,USA,37,36,31,104,120,123,243,329484123
2020,Tokyo,Japan,Uruguay,URU,0,0,0,0,1,1,2,3473727
2020,Tokyo,Japan,Uzbekistan,UZB,8,5,6,19,25,19,44,34232050
2020,Tokyo,Japan,Venezuela,VEN,3,2,2,7,13,14,27,28435943
2020,Tokyo,Japan,Vietnam,VIE,0,1,0,1,4,3,7,97338583
2020,Tokyo,Japan,US Virgin Islands,ISV,0,0,0,0,0,1,1,106290
2020,Tokyo,Japan,Yemen,YEM,0,0,0,0,1,1,2,29825968
2020,Tokyo,Japan,Zambia,ZAM,0,0,0,0,0,1,1,18383956
2020,Tokyo,Japan,Zimbabwe,ZIM,0,0,0,0,0,2,2,14862927
